В четырехугольнике FHVJ, если ∠A = ∠C и ∠B = ∠D, как называется четырехугольник?	[{"type": "quadrilateral", "name": "FHVJ"}]
Найдите площадь четырехугольника YXLM с вершинами в точках (0, 0), (8, 0), (8, 12) и (0, 12).	[{"type": "quadrilateral", "name": "YXLM"}]
Найдите площадь квадрата FTDU с вершинами в точках (0, 0), (12, 0), (12, 12) и (0, 12).	[{"type": "square", "name": "FTDU"}]
Определите периметр тупоугольного треугольника XWP со сторонами 30 см, 32 см и 38 см и остроугольного треугольника UQY с углами 30°, 60° и 90°	[{"type": "triangle", "name": "XWP"}, {"type": "triangle", "name": "UQY"}]
Если стороны треугольника IEB относятся как 2:3:5, найдите длину самой длинной стороны, если периметр равен 60 см.	[{"type": "triangle", "name": "IEB"}]
Найдите периметр квадрата FSHW со стороной 32 см.	[{"type": "square", "name": "FSHW"}]
В параллелограмме ORAH, если ∠A = 72°, найдите величину ∠B.	[{"type": "parallelogram", "name": "ORAH"}]
Найдите длину диагонали квадрата RVGU со стороной 20 см.	[{"type": "square", "name": "RVGU"}]
Найдите величину ∠A в трапеции YBOI, если AB = 15 см, BC = 18 см, CD = 15 см и DA = 18 см.	[{"type": "trapezoid", "name": "YBOI"}]
Найдите длину медианы трапеции HQSW, основания которой равны 16 см и 18 см, а высота — 12 см.	[{"type": "trapezoid", "name": "HQSW"}]
Докажите, что диагонали параллелограмма GSIE точкой пересечения делятся пополам.	[{"type": "parallelogram", "name": "GSIE"}]
Вычислите высоту равностороннего треугольника YBU со стороной 36 см и разностороннего треугольника ZIH со сторонами 38 см, 40 см и 44 см	[{"type": "triangle", "name": "YBU"}, {"type": "triangle", "name": "ZIH"}]
Докажите, что диагонали трапеции IJAC пересекаются под углом 90°.	[{"type": "trapezoid", "name": "IJAC"}]
Вычислите площадь треугольника TEC, если стороны равны 4 см, 5 см и 7 см.	[{"type": "triangle", "name": "TEC"}]
Найдите величину ∠A в параллелограмме YZSO, если диагонали AC и BD пересекаются под углом 30°.	[{"type": "parallelogram", "name": "YZSO"}]
Определите сумму внутренних углов остроугольного треугольника TZD с углами 45°, 60° и 75° и равностороннего треугольника QRY со стороной 84 см	[{"type": "triangle", "name": "TZD"}, {"type": "triangle", "name": "QRY"}]
В параллелограмме UPNS, если ∠A = 90°, найдите величину ∠B.	[{"type": "parallelogram", "name": "UPNS"}]
Найдите сумму внутренних углов равнобедренного треугольника IRY с основанием 22 см и равными сторонами 20 см, а также разностороннего треугольника UFJ со сторонами 25 см, 27 см и 30 см	[{"type": "triangle", "name": "IRY"}, {"type": "triangle", "name": "UFJ"}]
Найдите периметр параллелограмма YDSA, стороны которого равны 10 см и 12 см.	[{"type": "parallelogram", "name": "YDSA"}]
Найдите периметр квадрата SEMU со стороной 12 см.	[{"type": "square", "name": "SEMU"}]
Найдите сумму внутренних углов равностороннего треугольника GQC со стороной 46 см и прямоугольного треугольника EYO со сторонами 50 см и 60 см	[{"type": "triangle", "name": "GQC"}, {"type": "triangle", "name": "EYO"}]
Определите площадь треугольника NXA со сторонами длиной 3, 4 и 5 единиц, используя закон косинусов и тот факт, что это равнобедренный треугольник	[{"type": "triangle", "name": "NXA"}]
Вычислите длину медианы из вершины R в треугольнике IMJ со сторонами длиной 5, 12 и 13 единиц.	[{"type": "triangle", "name": "IMJ"}]
Докажите, что диагонали трапеции LOCF не обязательно являются взаимно перпендикулярными биссектрисами.	[{"type": "trapezoid", "name": "LOCF"}]
Как называется параллелограмм RXKV, у которого все стороны имеют одинаковую длину?	[{"type": "parallelogram", "name": "RXKV"}]
Докажите, что сумма внутренних углов квадрата ADKU равна 360°.	[{"type": "square", "name": "ADKU"}]
Докажите, что диагонали квадрата QDVY являются взаимно перпендикулярными биссектрисами.	[{"type": "square", "name": "QDVY"}]
Найдите длину медианы трапеции KVTD, основания которой равны 20 см и 22 см, а высота — 14 см.	[{"type": "trapezoid", "name": "KVTD"}]
Как называется квадрат TCJK, у которого все стороны одинаковой длины и все углы прямые?	[{"type": "square", "name": "TCJK"}]
Определите, является ли треугольник LXN равнобедренным, если оба угла, лежащие против равных сторон, равны 45°.	[{"type": "triangle", "name": "LXN"}]
В параллелограмме UNCY, если ∠A = 75°, найдите величину ∠B.	[{"type": "parallelogram", "name": "UNCY"}]
Найдите величину ∠C в трапеции LBVT, если ∠A = 60°.	[{"type": "trapezoid", "name": "LBVT"}]
В четырехугольнике ZQDM, если AB = CD и AD = BC, найдите величину ∠A.	[{"type": "quadrilateral", "name": "ZQDM"}]
В четырехугольнике RTKN, если ∠A = 80° и ∠B = 70°, найдите сумму оставшихся двух углов.	[{"type": "quadrilateral", "name": "RTKN"}]
Найдите площадь трапеции BMIW, основания которой равны 15 см и 18 см, а высота 12 см.	[{"type": "trapezoid", "name": "BMIW"}]
Докажите, что диагонали параллелограмма GVJY точкой пересечения делятся пополам.	[{"type": "parallelogram", "name": "GVJY"}]
Вычислите высоту разностороннего треугольника WYV со сторонами 32 см, 34 см и 40 см, а также равнобедренного треугольника DXZ с основанием 30 см и равными сторонами 28 см	[{"type": "triangle", "name": "WYV"}, {"type": "triangle", "name": "DXZ"}]
Найдите длину диагонали квадрата TQRP со стороной 20 см.	[{"type": "square", "name": "TQRP"}]
Найдите площадь треугольника HCR, если высота 9 см, а основание 12 см.	[{"type": "triangle", "name": "HCR"}]
Докажите, что противолежащие углы параллелограмма MWDK являются дополнительными.	[{"type": "parallelogram", "name": "MWDK"}]
В четырехугольнике HJZK, если AB = 10 см, BC = 12 см, CD = 15 см и DA = 16 см, ∠A = 70°, найдите меру ∠B.	[{"type": "quadrilateral", "name": "HJZK"}]
В треугольнике MHZ, если высота от вершины P до стороны QR равна 7 см, а площадь 49 см², найдите длину QR.	[{"type": "triangle", "name": "MHZ"}]
Докажите, что диагонали параллелограмма NHKZ являются взаимно перпендикулярными и серединными.	[{"type": "parallelogram", "name": "NHKZ"}]
Как называется трапеция MEFI, у которой все углы прямые?	[{"type": "trapezoid", "name": "MEFI"}]
Как называется квадрат TJZU, у которого все стороны одинаковой длины и все углы прямые?	[{"type": "square", "name": "TJZU"}]
Докажите, что диагонали трапеции TOSE не обязательно являются взаимно перпендикулярными биссектрисами.	[{"type": "trapezoid", "name": "TOSE"}]
Найдите площадь прямоугольного треугольника SHA с катетами 100 см и 130 см, а также равностороннего треугольника TOL со стороной 100 см	[{"type": "triangle", "name": "SHA"}, {"type": "triangle", "name": "TOL"}]
Какова площадь трапеции CMDS, основания которой равны 18 см и 20 см, а высота 14 см?	[{"type": "trapezoid", "name": "CMDS"}]
Как называется параллелограмм RIVY, у которого все углы прямые?	[{"type": "parallelogram", "name": "RIVY"}]
Найдите длину стороны равностороннего треугольника GCA, периметр которого равен 42 см.	[{"type": "triangle", "name": "GCA"}]
Как называется четырехугольник ELSW, если диагонали AC и BD делят друг друга пополам?	[{"type": "quadrilateral", "name": "ELSW"}]
В квадрате LUHI, если AB = CD и AD = BC, как называется квадрат?	[{"type": "square", "name": "LUHI"}]
Найдите величину ∠B в трапеции ZSKJ, если ∠A = 90°.	[{"type": "trapezoid", "name": "ZSKJ"}]
Найдите длину высоты из вершины А в треугольнике ZEJ со сторонами длиной 11, 12 и 13 единиц. Используйте эту информацию, чтобы найти площадь треугольника.	[{"type": "triangle", "name": "ZEJ"}]
Докажите, что противоположные стороны трапеции UHXA не обязательно параллельны.	[{"type": "trapezoid", "name": "UHXA"}]
Определите гипотенузу прямоугольного треугольника QWE с катетами 28 см и 32 см и тупоугольного треугольника HIT с углами 110°, 40° и 30°	[{"type": "triangle", "name": "QWE"}, {"type": "triangle", "name": "HIT"}]
Докажите, что сумма внутренних углов квадрата PHYQ равна 360°.	[{"type": "square", "name": "PHYQ"}]
Определите сумму внутренних углов разностороннего треугольника AOG со сторонами 7 см, 9 см и 11 см и прямоугольного треугольника ITE с катетами 8 см и 15 см	[{"type": "triangle", "name": "AOG"}, {"type": "triangle", "name": "ITE"}]
В квадрате XICR, если ∠A = 90°, найдите меру ∠D.	[{"type": "square", "name": "XICR"}]
Найдите длину диагонали четырехугольника NBOK со сторонами 6 см, 8 см и 10 см.	[{"type": "quadrilateral", "name": "NBOK"}]
Найдите длину диагонали трапеции BTJV, основания которой равны 18 см и 20 см, а высота — 14 см.	[{"type": "trapezoid", "name": "BTJV"}]
Определите площадь треугольника LHO, полупериметр которого равен 12 единицам, а углы 60°, 60° и 120°	[{"type": "triangle", "name": "LHO"}]
Какова площадь квадрата JDKA со стороной 18 см?	[{"type": "square", "name": "JDKA"}]
Вычислите высоту разностороннего треугольника LPW со сторонами 100 см, 102 см и 130 см, а также равнобедренного треугольника GDJ с основанием 88 см и равными сторонами 86 см	[{"type": "triangle", "name": "LPW"}, {"type": "triangle", "name": "GDJ"}]
Вычислите длину высоты из вершины A в треугольнике TCF со сторонами длиной 3, 4 и 5 единиц и используйте ее, чтобы найти длину биссектрисы угла B	[{"type": "triangle", "name": "TCF"}]
Найдите высоту остроугольного треугольника IDK с углами 45°, 60° и 75°, а также равнобедренного треугольника GVY с основанием 40 см и равными сторонами 38 см	[{"type": "triangle", "name": "IDK"}, {"type": "triangle", "name": "GVY"}]
В параллелограмме UGVA, если ∠A = 90°, найдите величину ∠B.	[{"type": "parallelogram", "name": "UGVA"}]
Найдите площадь треугольника KUH, если стороны равны 6 см, 8 см и 10 см.	[{"type": "triangle", "name": "KUH"}]
Найдите самую длинную сторону треугольника GJB, учитывая, что две другие стороны равны и имеют длину 9 см каждая.	[{"type": "triangle", "name": "GJB"}]
Докажите, что противоположные стороны четырехугольника GVQS не обязательно параллельны.	[{"type": "quadrilateral", "name": "GVQS"}]
Найдите периметр квадрата WTKI со стороной 18 см.	[{"type": "square", "name": "WTKI"}]
Вычислите периметр равностороннего треугольника IZH со стороной 9 см и тупоугольного треугольника KNL со сторонами 8 см, 10 см и 12 см	[{"type": "triangle", "name": "IZH"}, {"type": "triangle", "name": "KNL"}]
Докажите, что диагонали квадрата UGDS пересекаются и делятся пополам под углом 90°.	[{"type": "square", "name": "UGDS"}]
Найдите величину ∠C в трапеции YVUP, если ∠A = 60°.	[{"type": "trapezoid", "name": "YVUP"}]
Вычислите углы треугольника ZTB, если два угла дополнительные, а третий угол равен 40°.	[{"type": "triangle", "name": "ZTB"}]
Определите, является ли треугольник GQR косоугольным, если его стороны имеют длины 5, 6 и 7 единиц	[{"type": "triangle", "name": "GQR"}]
Как называется квадрат KLTC, у которого все стороны одинаковой длины и все углы прямые?	[{"type": "square", "name": "KLTC"}]
Докажите, что противолежащие углы параллелограмма XZIA равны.	[{"type": "parallelogram", "name": "XZIA"}]
Найдите площадь параллелограмма QYEC с вершинами в точках (0, 0), (6, 0), (6, 10) и (0, 10).	[{"type": "parallelogram", "name": "QYEC"}]
Докажите, что противоположные стороны трапеции OECL не обязательно параллельны.	[{"type": "trapezoid", "name": "OECL"}]
Найдите сумму внутренних углов равностороннего треугольника WJQ со стороной 96 см и прямоугольного треугольника ITX со сторонами 98 см и 128 см	[{"type": "triangle", "name": "WJQ"}, {"type": "triangle", "name": "ITX"}]
В квадрате HJTQ, если ∠A = 90°, найдите величины оставшихся трех углов.	[{"type": "square", "name": "HJTQ"}]
Вычислите сумму внутренних углов тупоугольного треугольника HIX с углами 120°, 40° и 20° и остроугольного треугольника GCQ с углами 30°, 60° и 90°	[{"type": "triangle", "name": "HIX"}, {"type": "triangle", "name": "GCQ"}]
Найдите периметр квадрата EOPX со стороной 70 см.	[{"type": "square", "name": "EOPX"}]
В трапеции NDFE, если AB = CD и AD = BC, как называется трапеция?	[{"type": "trapezoid", "name": "NDFE"}]
Определите площадь треугольника YTE со сторонами длиной 5, 6 и 7 единиц с помощью тригонометрических функций	[{"type": "triangle", "name": "YTE"}]
Определите, является ли треугольник AVL равнобедренным, если оба угла при основании равны 40°.	[{"type": "triangle", "name": "AVL"}]
Как называется трапеция VANY, у которой все углы прямые?	[{"type": "trapezoid", "name": "VANY"}]
Как называется квадрат ALRW, у которого все углы прямые?	[{"type": "square", "name": "ALRW"}]
В квадрате TJQH, если AB = CD и AD = BC, как называется квадрат?	[{"type": "square", "name": "TJQH"}]
Вычислите высоту равностороннего треугольника GWH со стороной 82 см и разностороннего треугольника YNM со сторонами 84 см, 86 см и 102 см	[{"type": "triangle", "name": "GWH"}, {"type": "triangle", "name": "YNM"}]
Вычислите высоту тупоугольного треугольника HCY с углами 100°, 40° и 40°, а также равностороннего треугольника KLT со стороной 10 см	[{"type": "triangle", "name": "HCY"}, {"type": "triangle", "name": "KLT"}]
Вычислите высоту равностороннего треугольника UDC со стороной 88 см и остроугольного треугольника LMT с углами 30°, 60° и 90°	[{"type": "triangle", "name": "UDC"}, {"type": "triangle", "name": "LMT"}]
Как называется четырехугольник VGYP, если AB = CD и AD = BC?	[{"type": "quadrilateral", "name": "VGYP"}]
Найдите длину диагонали параллелограмма FPRB, стороны которого равны 8 см и 10 см.	[{"type": "parallelogram", "name": "FPRB"}]
В квадрате KIDY, если AB = CD и AD = BC, как называется квадрат?	[{"type": "square", "name": "KIDY"}]
Найдите длину QR треугольника GAT, если высота от вершины P до стороны QR равна 6 см, а площадь 36 см².	[{"type": "triangle", "name": "GAT"}]
Найдите длину медианы из вершины А в треугольнике SUN со сторонами длиной 3, 4 и 5 единиц. Докажите, что эта медиана является самой короткой стороной треугольника.	[{"type": "triangle", "name": "SUN"}]
Найдите площадь квадрата RSWJ со стороной 25 см.	[{"type": "square", "name": "RSWJ"}]
Найдите сумму внутренних углов равнобедренного треугольника FDP с основанием 80 см и равными сторонами 78 см, а также разностороннего треугольника OMV со сторонами 92 см, 94 см и 116 см	[{"type": "triangle", "name": "FDP"}, {"type": "triangle", "name": "OMV"}]
Определите, является ли треугольник YMF равнобедренным, если его стороны имеют длины 5, 19 и 12 единиц	[{"type": "triangle", "name": "YMF"}]
Найдите площадь квадрата GZBA со стороной 15 см.	[{"type": "square", "name": "GZBA"}]
Какова площадь квадрата AXIY, длина стороны которого 35 см?	[{"type": "square", "name": "AXIY"}]
Как называется трапеция HAJC, у которой все стороны имеют одинаковую длину?	[{"type": "trapezoid", "name": "HAJC"}]
Вычислите высоту равностороннего треугольника NWF со стороной 66 см и остроугольного треугольника BQT с углами 30°, 60° и 90°	[{"type": "triangle", "name": "NWF"}, {"type": "triangle", "name": "BQT"}]
В параллелограмме UDRW, если ∠A = 90°, найдите величину ∠B.	[{"type": "parallelogram", "name": "UDRW"}]
Докажите, что диагонали квадрата PAOY являются взаимно перпендикулярными биссектрисами.	[{"type": "square", "name": "PAOY"}]
Найдите площадь четырехугольника NWME, основание которого равно 15 см, а высота — 12 см.	[{"type": "quadrilateral", "name": "NWME"}]
Найдите периметр трапеции MRUC, основания которой равны 25 см и 28 см, а высота 20 см.	[{"type": "trapezoid", "name": "MRUC"}]
Докажите, что диагонали квадрата GDEV являются взаимно перпендикулярными биссектрисами.	[{"type": "square", "name": "GDEV"}]
Определите сумму внутренних углов остроугольного треугольника RZB с углами 45°, 60° и 75° и равностороннего треугольника UHN со стороной 22 см	[{"type": "triangle", "name": "RZB"}, {"type": "triangle", "name": "UHN"}]
Определите гипотенузу остроугольного треугольника MIN с углами 45°, 60° и 75° и разностороннего треугольника KTR со сторонами 55 см, 57 см и 67 см	[{"type": "triangle", "name": "MIN"}, {"type": "triangle", "name": "KTR"}]
Докажите, что диагонали параллелограмма NPIY точкой пересечения образуют угол 90°.	[{"type": "parallelogram", "name": "NPIY"}]
Найдите величину ∠C в трапеции QKHE, если ∠A = 110°.	[{"type": "trapezoid", "name": "QKHE"}]
Найдите периметр трапеции YVNI, основания которой равны 12 см и 15 см, а высота 10 см.	[{"type": "trapezoid", "name": "YVNI"}]
Докажите, что сумма внутренних углов квадрата DWZF равна 360°.	[{"type": "square", "name": "DWZF"}]
Найдите периметр параллелограмма JTCP, стороны которого равны 14 см и 17 см.	[{"type": "parallelogram", "name": "JTCP"}]
Определите гипотенузу прямоугольного треугольника NOJ с катетами 94 см и 118 см и тупоугольного треугольника EGA с углами 125°, 40° и 15°	[{"type": "triangle", "name": "NOJ"}, {"type": "triangle", "name": "EGA"}]
Найдите высоту остроугольного треугольника KUH с углами 45°, 60° и 75°, а также равнобедренного треугольника MBP с основанием 25 см и равными сторонами 23 см	[{"type": "triangle", "name": "KUH"}, {"type": "triangle", "name": "MBP"}]
Определите длину высоты из вершины A в треугольнике MNG со сторонами длиной 7, 8 и 9 единиц и найдите его уравнение, используя точку S(2, 3), лежащую на ней.	[{"type": "triangle", "name": "MNG"}]
Определите гипотенузу остроугольного треугольника XEP с углами 45°, 60° и 75° и разностороннего треугольника DAS со сторонами 78 см, 80 см и 96 см	[{"type": "triangle", "name": "XEP"}, {"type": "triangle", "name": "DAS"}]
В треугольнике RVM, если углы относятся как 2:3:4, найдите величину наибольшего угла.	[{"type": "triangle", "name": "RVM"}]
Найдите периметр четырехугольника IUBE со сторонами 5 см, 6 см, 7 см и 8 см.	[{"type": "quadrilateral", "name": "IUBE"}]
Найдите величину ∠C в параллелограмме GMXR, если ∠A = 50°.	[{"type": "parallelogram", "name": "GMXR"}]
Найдите сумму внутренних углов равностороннего треугольника WKM со стороной 72 см и прямоугольного треугольника YGC со сторонами 74 см и 90 см	[{"type": "triangle", "name": "WKM"}, {"type": "triangle", "name": "YGC"}]
Найдите площадь остроугольного треугольника RFZ с углами 45°, 60° и 75°, а также равнобедренного треугольника ADX с основанием 5 см и равными сторонами 6 см	[{"type": "triangle", "name": "RFZ"}, {"type": "triangle", "name": "ADX"}]
Как называется четырехугольник QGCE с двумя парами параллельных сторон?	[{"type": "quadrilateral", "name": "QGCE"}]
Докажите, что противоположные стороны четырехугольника SJLK не обязательно равны.	[{"type": "quadrilateral", "name": "SJLK"}]
В квадрате JZQI, если AB = BC = CD = DA, найдите меру ∠C.	[{"type": "square", "name": "JZQI"}]
Определите периметр тупоугольного треугольника JNP со сторонами 74 см, 76 см и 92 см и остроугольного треугольника OUX с углами 30°, 60° и 90°	[{"type": "triangle", "name": "JNP"}, {"type": "triangle", "name": "OUX"}]
В квадрате QBWE, если ∠A = 90°, найдите величину ∠B.	[{"type": "square", "name": "QBWE"}]
В квадрате IHGY, если ∠A = 90°, найдите меру ∠D.	[{"type": "square", "name": "IHGY"}]
Как называется четырехугольник XNMR, у которого все стороны одинаковой длины и все углы прямые?	[{"type": "quadrilateral", "name": "XNMR"}]
Докажите, что диагонали параллелограмма IXDP являются взаимно перпендикулярными и серединными.	[{"type": "parallelogram", "name": "IXDP"}]
Найдите длину высоты из вершины А в треугольнике UVL со сторонами длиной 11, 12 и 13 единиц	[{"type": "triangle", "name": "UVL"}]
Найдите площадь параллелограмма MOSN, основание которого равно 12 см, а высота — 14 см.	[{"type": "parallelogram", "name": "MOSN"}]
Найдите сумму внутренних углов равнобедренного треугольника FGO с основанием 38 см и равными сторонами 36 см, а также разностороннего треугольника AYN со сторонами 45 см, 47 см и 53 см	[{"type": "triangle", "name": "FGO"}, {"type": "triangle", "name": "AYN"}]
Найдите величину ∠A в трапеции EWZC, если диагонали AC и BD пересекаются под углом 60°.	[{"type": "trapezoid", "name": "EWZC"}]
Определите площадь треугольника AVQ со сторонами длиной 5, 6 и 7 единиц по формуле Шолеса.	[{"type": "triangle", "name": "AVQ"}]
Найдите величину ∠C в параллелограмме KWXF, если ∠A = 45°.	[{"type": "parallelogram", "name": "KWXF"}]
В квадрате DERI, если ∠A = 90°, найдите величину ∠B.	[{"type": "square", "name": "DERI"}]
Найдите величину ∠C в параллелограмме BJAS, если ∠A = 45°.	[{"type": "parallelogram", "name": "BJAS"}]
В четырехугольнике MNEV, если AB = CD, как называется четырехугольник?	[{"type": "quadrilateral", "name": "MNEV"}]
Найдите площадь прямоугольного треугольника AFK с катетами 52 см и 64 см, а также равностороннего треугольника XGM со стороной 50 см	[{"type": "triangle", "name": "AFK"}, {"type": "triangle", "name": "XGM"}]
Как называется квадрат SDZK, у которого все углы прямые?	[{"type": "square", "name": "SDZK"}]
Найдите величину ∠A в квадрате TXFC, если диагонали AC и BD пересекаются под углом 90°.	[{"type": "square", "name": "TXFC"}]
Вычислите недостающую величину угла в треугольнике UGT, если углы относятся как 3:4:5.	[{"type": "triangle", "name": "UGT"}]
В треугольнике OAX, если углы относятся как 2:3:4, найдите величину среднего угла.	[{"type": "triangle", "name": "OAX"}]
Вычислите высоту равностороннего треугольника NRS со стороной 36 см и разностороннего треугольника CWV со сторонами 38 см, 40 см и 44 см	[{"type": "triangle", "name": "NRS"}, {"type": "triangle", "name": "CWV"}]
Как называется квадрат CVLQ, у которого все стороны одинаковой длины и все углы прямые?	[{"type": "square", "name": "CVLQ"}]
Найдите периметр четырехугольника YQCR со сторонами длиной 10 см, 12 см, 14 см и 16 см.	[{"type": "quadrilateral", "name": "YQCR"}]
Определите площадь треугольника HJY со сторонами длиной 5, 6 и 7 единиц по формуле Шолеса	[{"type": "triangle", "name": "HJY"}]
Найдите величину ∠C в параллелограмме YNGS, если ∠A = 45°.	[{"type": "parallelogram", "name": "YNGS"}]
Найдите периметр параллелограмма ZSBU, стороны которого равны 15 см и 19 см.	[{"type": "parallelogram", "name": "ZSBU"}]
Найдите периметр равностороннего треугольника JAH со стороной 5 см и равнобедренного треугольника NOU с основанием 6 см и равными сторонами 4 см	[{"type": "triangle", "name": "JAH"}, {"type": "triangle", "name": "NOU"}]
Вычислите длину гипотенузы треугольника RHN со сторонами длиной 8 и 15 единиц	[{"type": "triangle", "name": "RHN"}]
Найдите периметр параллелограмма EOVD, стороны которого равны 9 см и 11 см.	[{"type": "parallelogram", "name": "EOVD"}]
Каков периметр трапеции ZIQT, основания которой имеют длины 20 см и 25 см, а высота 18 см?	[{"type": "trapezoid", "name": "ZIQT"}]
Определите площадь прямоугольного треугольника GLR с катетами 15 см и 20 см, а также остроугольного треугольника SOF с углами 30°, 60° и 90°	[{"type": "triangle", "name": "GLR"}, {"type": "triangle", "name": "SOF"}]
Определите, имеет ли треугольник ULX стороны длиной 6, 8 и 10 единиц и является ли треугольник Пифагора (т. е. квадрат одной стороны равен сумме квадратов двух других сторон).	[{"type": "triangle", "name": "ULX"}]
Вычислите высоту равностороннего треугольника TQG со стороной 82 см и разностороннего треугольника BWP со сторонами 84 см, 86 см и 102 см	[{"type": "triangle", "name": "TQG"}, {"type": "triangle", "name": "BWP"}]
Как называется четырехугольник NZKA, если диагонали AC и BD перпендикулярны друг другу?	[{"type": "quadrilateral", "name": "NZKA"}]
Докажите, что диагонали трапеции TMEH не обязательно являются взаимно перпендикулярными биссектрисами.	[{"type": "trapezoid", "name": "TMEH"}]
Вычислите углы треугольника DOI, если два угла являются дополнительными, а третий угол равен 75°.	[{"type": "triangle", "name": "DOI"}]
Найдите длину диагонали трапеции ECIZ, основания которой равны 18 см и 20 см, а высота — 14 см.	[{"type": "trapezoid", "name": "ECIZ"}]
Найдите периметр трапеции GXMI, основания которой равны 16 см и 18 см, а высота 12 см.	[{"type": "trapezoid", "name": "GXMI"}]
Как называется квадрат DZBR, у которого все стороны одинаковой длины и все углы прямые?	[{"type": "square", "name": "DZBR"}]
Найдите величину ∠A в трапеции FDYH, если диагонали AC и BD пересекаются под углом 45°.	[{"type": "trapezoid", "name": "FDYH"}]
Найдите площадь квадрата MJYI со стороной 25 см.	[{"type": "square", "name": "MJYI"}]
В трапеции XTNK, если AB = CD и AD = BC, как называется трапеция?	[{"type": "trapezoid", "name": "XTNK"}]
Докажите, что сумма внутренних углов трапеции HINR равна 360°.	[{"type": "trapezoid", "name": "HINR"}]
Как называется параллелограмм XMVP, у которого все углы прямые?	[{"type": "parallelogram", "name": "XMVP"}]
В трапеции MFOB, если AB = CD и AD = BC, как называется трапеция?	[{"type": "trapezoid", "name": "MFOB"}]
Найдите длину диагонали четырехугольника EZFB, стороны которого равны 16 см, 18 см и 20 см.	[{"type": "quadrilateral", "name": "EZFB"}]
Вычислите длину медиан треугольника IOU со сторонами длиной 5, 6 и 7 единиц	[{"type": "triangle", "name": "IOU"}]
В четырехугольнике QPYG, если AB = CD и AD = BC, найти меру ∠A.	[{"type": "quadrilateral", "name": "QPYG"}]
Как называется четырехугольник QOZS, если AB = CD и AD ≠ BC?	[{"type": "quadrilateral", "name": "QOZS"}]
Докажите, что диагонали трапеции BKUR пересекаются под углом 90°.	[{"type": "trapezoid", "name": "BKUR"}]
Найдите величину ∠B в трапеции NLPV, если ∠A = 90°.	[{"type": "trapezoid", "name": "NLPV"}]
Найдите величину ∠A в параллелограмме AWBR, если AB = 10 см, BC = 12 см, CD = 10 см и DA = 12 см.	[{"type": "parallelogram", "name": "AWBR"}]
Найдите длину диагонали трапеции VTKR, основания которой равны 20 см и 22 см, а высота — 14 см.	[{"type": "trapezoid", "name": "VTKR"}]
Найдите длину стороны равностороннего треугольника CQJ, периметр которого равен 18 см.	[{"type": "triangle", "name": "CQJ"}]
В четырехугольнике DQCB, если ∠A = 90° и ∠B = 45°, найдите величину ∠C.	[{"type": "quadrilateral", "name": "DQCB"}]
Найдите недостающий угол в прямоугольном треугольнике KAY, длина катета которого равна 7 см, а гипотенуза 25 см.	[{"type": "triangle", "name": "KAY"}]
Как называется параллелограмм WJCV, у которого все стороны имеют одинаковую длину и все внутренние углы имеют одинаковую величину?	[{"type": "parallelogram", "name": "WJCV"}]
Как называется четырехугольник MDKH, если AC = BD?	[{"type": "quadrilateral", "name": "MDKH"}]
В четырехугольнике ESOM, если AB = CD и AD = BC, найдите величину ∠A.	[{"type": "quadrilateral", "name": "ESOM"}]
Как называется квадрат NVJR, у которого все углы прямые?	[{"type": "square", "name": "NVJR"}]
Найдите площадь параллелограмма SNZA, основание которого равно 12 см, а высота — 10 см.	[{"type": "parallelogram", "name": "SNZA"}]
Определите, является ли треугольник OJG прямоугольным, если гипотенуза равна 12 см, а длина одного катета 7 см.	[{"type": "triangle", "name": "OJG"}]
Определите, является ли треугольник CNK тупым треугольником, когда его стороны имеют длину 5, 12 и 13 единиц	[{"type": "triangle", "name": "CNK"}]
Найдите площадь параллелограмма OGFJ с вершинами в точках (0, 0), (7, 0), (7, 12) и (0, 12).	[{"type": "parallelogram", "name": "OGFJ"}]
Найдите величину ∠B в трапеции JOYP, если ∠A = 90°.	[{"type": "trapezoid", "name": "JOYP"}]
Найдите площадь четырехугольника AIVR с вершинами в точках (0, 0), (2, 0), (2, 4) и (0, 4).	[{"type": "quadrilateral", "name": "AIVR"}]
Как называется параллелограмм ONDW, у которого все стороны имеют одинаковую длину и все внутренние углы имеют одинаковую величину?	[{"type": "parallelogram", "name": "ONDW"}]
Определите гипотенузу остроугольного треугольника EIA с углами 45°, 60° и 75° и разностороннего треугольника GUR со сторонами 78 см, 80 см и 96 см	[{"type": "triangle", "name": "EIA"}, {"type": "triangle", "name": "GUR"}]
Докажите, что диагонали четырехугольника WFRH точкой пересечения делятся пополам.	[{"type": "quadrilateral", "name": "WFRH"}]
Определите площадь тупоугольного треугольника KLQ со сторонами 90 см, 92 см и 114 см, а также прямоугольного треугольника SRT с катетами 92 см и 120 см	[{"type": "triangle", "name": "KLQ"}, {"type": "triangle", "name": "SRT"}]
Как называется четырехугольник FUDW, если AB = CD и AD ≠ BC?	[{"type": "quadrilateral", "name": "FUDW"}]
Вычислите углы треугольника KJX, если два угла равны и каждый равен 50°.	[{"type": "triangle", "name": "KJX"}]
Какова площадь квадрата PYTB со стороной 20 см?	[{"type": "square", "name": "PYTB"}]
Докажите, что диагонали квадрата BDOY являются взаимно перпендикулярными биссектрисами.	[{"type": "square", "name": "BDOY"}]
Определите сумму внутренних углов остроугольного треугольника AJC с углами 45°, 60° и 75° и равностороннего треугольника IKV со стороной 22 см	[{"type": "triangle", "name": "AJC"}, {"type": "triangle", "name": "IKV"}]
Вычислите недостающую величину угла в треугольнике MCI, если углы относятся как 5:7:8.	[{"type": "triangle", "name": "MCI"}]
Найдите длину диагонали параллелограмма GADX, стороны которого равны 16 см и 20 см.	[{"type": "parallelogram", "name": "GADX"}]
Как называется параллелограмм LAWI, у которого все стороны имеют одинаковую длину?	[{"type": "parallelogram", "name": "LAWI"}]
В треугольнике ZFV, если высота от вершины P до стороны QR равна 8 см, а площадь 32 см², найдите длину QR.	[{"type": "triangle", "name": "ZFV"}]
Определите, является ли треугольник ROB прямоугольным, если гипотенуза равна 11 см, а длина одного катета 9 см.	[{"type": "triangle", "name": "ROB"}]
Докажите, что противоположные стороны параллелограмма ZADV параллельны.	[{"type": "parallelogram", "name": "ZADV"}]
Найдите площадь параллелограмма LOFA, основание которого равно 12 см, а высота — 10 см.	[{"type": "parallelogram", "name": "LOFA"}]
Найдите площадь трапеции ZSAK с вершинами в точках (0, 0), (12, 0), (15, 18) и (0, 18).	[{"type": "trapezoid", "name": "ZSAK"}]
Вычислите длину высоты из вершины C в треугольнике DAR со сторонами длиной 3, 4 и 5 единиц и используйте ее, чтобы найти длину биссектрисы угла C	[{"type": "triangle", "name": "DAR"}]
Определите, лежит ли точка D на описанной окружности треугольника LBE со сторонами длиной 5, 6 и 7 единиц	[{"type": "triangle", "name": "LBE"}]
В треугольнике KNU, если высота от вершины P до стороны QR равна 5 см, а площадь 20 см², найдите длину QR.	[{"type": "triangle", "name": "KNU"}]
Как называется четырехугольник AZPG, если AB = CD и AD = BC?	[{"type": "quadrilateral", "name": "AZPG"}]
Найдите периметр четырехугольника VLPR со сторонами 5 см, 6 см, 7 см и 9 см.	[{"type": "quadrilateral", "name": "VLPR"}]
Найдите площадь четырехугольника KOVB, основание которого равно 12 см, высота — 9 см, а один из углов равен 45°.	[{"type": "quadrilateral", "name": "KOVB"}]
В треугольнике YGX, если углы относятся как 3:4:5, найдите величину наибольшего угла.	[{"type": "triangle", "name": "YGX"}]
Докажите, что диагонали трапеции OEBJ пересекаются под углом 90°.	[{"type": "trapezoid", "name": "OEBJ"}]
Найдите площадь параллелограмма LJWK, основание которого равно 12 см, а высота — 14 см.	[{"type": "parallelogram", "name": "LJWK"}]
В треугольнике PWF, если высота от вершины P до стороны QR равна 4 см, а площадь 16 см², найдите длину QR.	[{"type": "triangle", "name": "PWF"}]
Найдите периметр трапеции AYEG, основания которой равны 15 см и 20 см, а высота 12 см.	[{"type": "trapezoid", "name": "AYEG"}]
Найдите площадь параллелограмма XOJI, основание которого равно 9 см, а высота — 7 см.	[{"type": "parallelogram", "name": "XOJI"}]
Вычислите углы треугольника ABE, учитывая, что угол A и угол C являются дополнительными.	[{"type": "triangle", "name": "ABE"}]
Вычислите недостающую величину угла в треугольнике HFE, если два угла равны и каждый равен 40°.	[{"type": "triangle", "name": "HFE"}]
Найдите периметр трапеции JMTD, основания которой равны 25 см и 28 см, а высота 20 см.	[{"type": "trapezoid", "name": "JMTD"}]
Найдите площадь трапеции KGRC с вершинами в точках (0, 0), (12, 0), (15, 18) и (0, 18).	[{"type": "trapezoid", "name": "KGRC"}]
Найдите длину диагонали квадрата RSXM со стороной 55 см.	[{"type": "square", "name": "RSXM"}]
Найдите длину диагонали параллелограмма GWEC, стороны которого равны 8 см и 10 см.	[{"type": "parallelogram", "name": "GWEC"}]
Определите периметр прямоугольного треугольника GUY со сторонами 88 см и 108 см и разностороннего треугольника XVN со сторонами 90 см, 92 см и 112 см	[{"type": "triangle", "name": "GUY"}, {"type": "triangle", "name": "XVN"}]
Найдите величину ∠B в трапеции JIRY, если ∠A = 90°.	[{"type": "trapezoid", "name": "JIRY"}]
Вычислите недостающую величину угла в треугольнике IBF, учитывая, что угол K и угол L равны 45°.	[{"type": "triangle", "name": "IBF"}]
Как называется трапеция EMRD с двумя парами равных сторон?	[{"type": "trapezoid", "name": "EMRD"}]
Найдите площадь четырехугольника HGTK, основание которого равно 10 см, высота 6 см и один угол равен 60°.	[{"type": "quadrilateral", "name": "HGTK"}]
В параллелограмме UJGV, если ∠A = 75°, найдите величину ∠B.	[{"type": "parallelogram", "name": "UJGV"}]
В трапеции KMDL, если AB = CD и AD = BC, как называется трапеция?	[{"type": "trapezoid", "name": "KMDL"}]
Найдите длину диагонали четырехугольника EQUZ, стороны которого равны 12 см, 14 см и 16 см.	[{"type": "quadrilateral", "name": "EQUZ"}]
Докажите, что противоположные стороны трапеции UNPB не обязательно параллельны.	[{"type": "trapezoid", "name": "UNPB"}]
Найдите площадь тупоугольного треугольника SMI с углами 115°, 40° и 25°, а также равнобедренного треугольника DVU с основанием 56 см и равными сторонами 54 см	[{"type": "triangle", "name": "SMI"}, {"type": "triangle", "name": "DVU"}]
Найдите величину ∠C в трапеции WIMT, если ∠A = 110°.	[{"type": "trapezoid", "name": "WIMT"}]
В четырехугольнике GUZB, если ∠A = 80° и ∠B = 100°, найдите сумму оставшихся двух углов.	[{"type": "quadrilateral", "name": "GUZB"}]
В трапеции KWNF, если ∠A = 90°, найдите меру ∠B.	[{"type": "trapezoid", "name": "KWNF"}]
Как называется квадрат ZBWU, у которого все стороны одинаковой длины и все углы прямые?	[{"type": "square", "name": "ZBWU"}]
Найдите периметр параллелограмма WMUD, стороны которого равны 12 см и 15 см.	[{"type": "parallelogram", "name": "WMUD"}]
Найдите величину ∠A в четырехугольнике TVQW, если AB = 18 см, BC = 20 см, CD = 18 см и DA = 20 см.	[{"type": "quadrilateral", "name": "TVQW"}]
Вычислите периметр треугольника KWO, если углы равны 50°, 60° и 70°.	[{"type": "triangle", "name": "KWO"}]
Как называется параллелограмм YZLT, у которого все стороны равны и все углы прямые?	[{"type": "parallelogram", "name": "YZLT"}]
Если стороны треугольника FLX относятся как 1:2:3, найдите длину самой длинной стороны, если периметр равен 45 см.	[{"type": "triangle", "name": "FLX"}]
Определите гипотенузу прямоугольного треугольника KOQ с катетами 5 см и 12 см и разностороннего треугольника WHT со сторонами 6 см, 8 см и 10 см	[{"type": "triangle", "name": "KOQ"}, {"type": "triangle", "name": "WHT"}]
Найдите периметр трапеции OUYJ, основания которой равны 20 см и 22 см, а высота — 14 см.	[{"type": "trapezoid", "name": "OUYJ"}]
Определите гипотенузу прямоугольного треугольника KUE с катетами 72 см и 86 см и тупоугольного треугольника HLQ с углами 120°, 40° и 20°	[{"type": "triangle", "name": "KUE"}, {"type": "triangle", "name": "HLQ"}]
Определите гипотенузу прямоугольного треугольника TMZ с катетами 28 см и 32 см и тупоугольного треугольника XAB с углами 110°, 40° и 30°	[{"type": "triangle", "name": "TMZ"}, {"type": "triangle", "name": "XAB"}]
Как называется квадрат EVRS, у которого все стороны имеют одинаковую длину?	[{"type": "square", "name": "EVRS"}]
Какова сумма внутренних углов параллелограмма JOXR?	[{"type": "parallelogram", "name": "JOXR"}]
Докажите, что диагонали квадрата XMDY пересекаются и делятся пополам под углом 90°.	[{"type": "square", "name": "XMDY"}]
В квадрате KTRQ, если ∠A = 90°, найдите величину ∠B.	[{"type": "square", "name": "KTRQ"}]
Определите, образует ли треугольник GTC со сторонами длиной 5, 6 и 7 единиц прямоугольный треугольник	[{"type": "triangle", "name": "GTC"}]
Найдите площадь трапеции EJQS с вершинами в точках (0, 0), (8, 0), (10, 12) и (0, 12).	[{"type": "trapezoid", "name": "EJQS"}]
Определите площадь разностороннего треугольника QGJ со сторонами 3 см, 4 см и 5 см, а также прямоугольного треугольника ZCN с катетами 3 см и 4 см	[{"type": "triangle", "name": "QGJ"}, {"type": "triangle", "name": "ZCN"}]
В четырехугольнике IVEP, если ∠A = 90°, найдите меру ∠B.	[{"type": "quadrilateral", "name": "IVEP"}]
Найдите периметр параллелограмма OPLM, стороны которого равны 7 см и 9 см.	[{"type": "parallelogram", "name": "OPLM"}]
Найдите величину ∠D в параллелограмме VTBE, если ∠A = 120°.	[{"type": "parallelogram", "name": "VTBE"}]
Найдите величину ∠A в параллелограмме FRGB, если диагонали AC и BD пересекаются под углом 30°.	[{"type": "parallelogram", "name": "FRGB"}]
Как называется четырехугольник OFJM, у которого все стороны имеют одинаковую длину и все внутренние углы имеют одинаковую величину?	[{"type": "quadrilateral", "name": "OFJM"}]
В трапеции HKZT, если ∠A = 80° и ∠B = 70°, найдите сумму оставшихся двух углов.	[{"type": "trapezoid", "name": "HKZT"}]
Как называется параллелограмм ZEWQ, у которого все стороны равны и все углы прямые?	[{"type": "parallelogram", "name": "ZEWQ"}]
Как называется параллелограмм GOHT, если AB = CD и AD = BC?	[{"type": "parallelogram", "name": "GOHT"}]
Какова сумма внутренних углов параллелограмма BJLO, один из углов которого равен 90°?	[{"type": "parallelogram", "name": "BJLO"}]
В прямоугольном треугольнике TXL, если катеты одинаковой длины, а гипотенуза равна 13 см, найдите длину каждого катета.	[{"type": "triangle", "name": "TXL"}]
В параллелограмме RKAY, если ∠A = 80°, найдите величину ∠B.	[{"type": "parallelogram", "name": "RKAY"}]
Найдите площадь трапеции LROV с вершинами в точках (0, 0), (10, 0), (12, 15) и (0, 15)	[{"type": "trapezoid", "name": "LROV"}]
Найдите площадь остроугольного треугольника OEP с углами 45°, 60° и 75° и разностороннего треугольника LDX со сторонами 16 см, 18 см и 22 см	[{"type": "triangle", "name": "OEP"}, {"type": "triangle", "name": "LDX"}]
Найдите площадь квадрата ZCNX со стороной 15 см.	[{"type": "square", "name": "ZCNX"}]
В параллелограмме ZTDU, если AB = 12 см, BC = 15 см, CD = 12 см и DA = 15 см, найдите величину ∠A.	[{"type": "parallelogram", "name": "ZTDU"}]
Найдите периметр равнобедренного треугольника LYP с основанием 18 см и равными сторонами 16 см, а также тупоугольного треугольника ISM со сторонами 20 см, 22 см и 26 см	[{"type": "triangle", "name": "LYP"}, {"type": "triangle", "name": "ISM"}]
В квадрате HWLI, если AB = CD и AD = BC, как называется квадрат?	[{"type": "square", "name": "HWLI"}]
В треугольнике ERM, если высота от вершины P до стороны QR равна 2 см, а площадь 12 см², найдите длину QR.	[{"type": "triangle", "name": "ERM"}]
В четырехугольнике SCIF, если AB = CD, как называется четырехугольник?	[{"type": "quadrilateral", "name": "SCIF"}]
В четырехугольнике DMAL, если ∠A = 90°, найдите меру ∠B.	[{"type": "quadrilateral", "name": "DMAL"}]
Найдите длину медианы из вершины A в треугольнике WNM с сторонами длины 7, 8 и 9 единиц и докажите, что это самая короткая сторона треугольника	[{"type": "triangle", "name": "WNM"}]
Вычислите высоту разностороннего треугольника CGO со сторонами 32 см, 34 см и 40 см, а также равнобедренного треугольника DKH с основанием 30 см и равными сторонами 28 см	[{"type": "triangle", "name": "CGO"}, {"type": "triangle", "name": "DKH"}]
Найдите сумму внутренних углов равностороннего треугольника WSR со стороной 46 см и прямоугольного треугольника LGM со сторонами 50 см и 60 см	[{"type": "triangle", "name": "WSR"}, {"type": "triangle", "name": "LGM"}]
В квадрате PEZF, если ∠A = 90°, найдите величину ∠B.	[{"type": "square", "name": "PEZF"}]
Найдите длину диагонали параллелограмма DUJQ, стороны которого равны 6 см и 8 см.	[{"type": "parallelogram", "name": "DUJQ"}]
Найдите величину ∠A в параллелограмме LYFS, если AB = 15 см, BC = 18 см, CD = 15 см и DA = 18 см.	[{"type": "parallelogram", "name": "LYFS"}]
Определить, образуют ли три данные точки равносторонний треугольник IUA	[{"type": "triangle", "name": "IUA"}]
Найдите площадь тупоугольного треугольника BLT с углами 120°, 40° и 20°, а также равнобедренного треугольника UGX с основанием 78 см и равными сторонами 76 см	[{"type": "triangle", "name": "BLT"}, {"type": "triangle", "name": "UGX"}]
Докажите, что диагонали четырехугольника LVIY делят друг друга пополам тогда и только тогда, когда этот четырехугольник является параллелограммом.	[{"type": "quadrilateral", "name": "LVIY"}]
Докажите, что диагонали параллелограмма CSVP равны.	[{"type": "parallelogram", "name": "CSVP"}]
Определите, является ли треугольник YWN равносторонним, если его стороны имеют длину 3, 3 и 3√3 единицы	[{"type": "triangle", "name": "YWN"}]
Как называется параллелограмм XMNW, если AB = CD и AD = BC?	[{"type": "parallelogram", "name": "XMNW"}]
Найдите высоту равнобедренного треугольника AXO с основанием 8 см и равными сторонами по 6 см, а также равностороннего треугольника VGD со стороной 7 см	[{"type": "triangle", "name": "AXO"}, {"type": "triangle", "name": "VGD"}]
Найдите длину диагонали параллелограмма VMYF, стороны которого равны 10 см и 12 см.	[{"type": "parallelogram", "name": "VMYF"}]
Докажите, что противоположные стороны параллелограмма ZFLC равны.	[{"type": "parallelogram", "name": "ZFLC"}]
Найдите величину ∠B в параллелограмме TDKL, если ∠A = 60°.	[{"type": "parallelogram", "name": "TDKL"}]
В параллелограмме XRJZ, если ∠A = 72°, найдите величину ∠B.	[{"type": "parallelogram", "name": "XRJZ"}]
Докажите, что диагонали параллелограмма ZRAE являются взаимно перпендикулярными и серединными.	[{"type": "parallelogram", "name": "ZRAE"}]
В квадрате TZFL, если AB = BC = CD = DA, найдите меру ∠C.	[{"type": "square", "name": "TZFL"}]
В треугольнике TSO угол D равен 70°, а угол F равен 4x. Найдите значение х.	[{"type": "triangle", "name": "TSO"}]
Вычислите высоту равностороннего треугольника PUN со стороной 88 см и остроугольного треугольника GOI с углами 30°, 60° и 90°	[{"type": "triangle", "name": "PUN"}, {"type": "triangle", "name": "GOI"}]
Вычислите высоту равностороннего треугольника EGX со стороной 60 см и разностороннего треугольника IML со сторонами 62 см, 64 см и 72 см	[{"type": "triangle", "name": "EGX"}, {"type": "triangle", "name": "IML"}]
Учитывая три точки A(-2, 3), B(1, 4) и C(5, -1), определите, образуют ли они правильный треугольник VWP. Если да, то классифицируйте треугольник как остроугольный, прямоугольный или тупоугольный в зависимости от его углов.	[{"type": "triangle", "name": "VWP"}]
Как называется четырехугольник EKBY, у которого все стороны одинаковой длины и все углы прямые?	[{"type": "quadrilateral", "name": "EKBY"}]
Докажите, что сумма внутренних углов четырехугольника LUQP равна 360°.	[{"type": "quadrilateral", "name": "LUQP"}]
Определите сумму внутренних углов прямоугольного треугольника GCU со сторонами 12 см и 16 см и разностороннего треугольника NJL со сторонами 14 см, 16 см и 20 см	[{"type": "triangle", "name": "GCU"}, {"type": "triangle", "name": "NJL"}]
Найдите длину диагонали параллелограмма DHFL, стороны которого равны 8 см и 10 см.	[{"type": "parallelogram", "name": "DHFL"}]
Как называется квадрат DRCI, у которого все стороны одинаковой длины и все углы прямые?	[{"type": "square", "name": "DRCI"}]
Найдите сумму внутренних углов разностороннего треугольника BYI со сторонами 58 см, 60 см и 68 см, а также равнобедренного треугольника LKW с основанием 50 см и равными сторонами 48 см	[{"type": "triangle", "name": "BYI"}, {"type": "triangle", "name": "LKW"}]
Найдите периметр четырехугольника FIOU со сторонами 3 см, 5 см, 7 см и 9 см.	[{"type": "quadrilateral", "name": "FIOU"}]
Определите площадь тупоугольного треугольника XGO со сторонами 42 см, 44 см и 50 см, а также прямоугольного треугольника QSC с катетами 45 см и 55 см	[{"type": "triangle", "name": "XGO"}, {"type": "triangle", "name": "QSC"}]
Найдите величину ∠C в трапеции CFHL, если ∠A = 100°.	[{"type": "trapezoid", "name": "CFHL"}]
Определите вершины треугольника IXJ с основанием длины 7 единиц и боковой стороной, равной половине длины основания	[{"type": "triangle", "name": "IXJ"}]
Найдите величину ∠C в параллелограмме OAHT, если ∠A = 45°.	[{"type": "parallelogram", "name": "OAHT"}]
Если стороны треугольника GAN относятся как 2:3:4, найдите длину самой длинной стороны, если периметр равен 84 см.	[{"type": "triangle", "name": "GAN"}]
Определите площадь треугольника ZTJ со сторонами длиной 3, 4 и 5 единиц, используя закон синусов	[{"type": "triangle", "name": "ZTJ"}]
Докажите, что диагонали трапеции LSMN не обязательно являются взаимно перпендикулярными биссектрисами.	[{"type": "trapezoid", "name": "LSMN"}]
Докажите, что сумма внутренних углов трапеции HWAT равна 360°.	[{"type": "trapezoid", "name": "HWAT"}]
Найдите длину диагонали четырехугольника WADB, стороны которого имеют длину 4 см, 6 см и 8 см.	[{"type": "quadrilateral", "name": "WADB"}]
Какова площадь четырехугольника QTPZ, основание которого равно 18 см, а высота — 16 см?	[{"type": "quadrilateral", "name": "QTPZ"}]
Вычислите периметр равностороннего треугольника EAL со стороной 9 см и тупоугольного треугольника WNS со сторонами 8 см, 10 см и 12 см	[{"type": "triangle", "name": "EAL"}, {"type": "triangle", "name": "WNS"}]
Определите гипотенузу прямоугольного треугольника MGF с катетами 72 см и 86 см и тупоугольного треугольника OPW с углами 120°, 40° и 20°	[{"type": "triangle", "name": "MGF"}, {"type": "triangle", "name": "OPW"}]
Найдите величину ∠A в четырехугольнике UDIS, если диагонали AC и BD пересекаются под углом 60°.	[{"type": "quadrilateral", "name": "UDIS"}]
В квадрате CRMK, если ∠A = 90°, найдите величины оставшихся трех углов.	[{"type": "square", "name": "CRMK"}]
Найдите площадь треугольника MQD, если стороны равны 8 см, 10 см и 12 см.	[{"type": "triangle", "name": "MQD"}]
Найдите площадь четырехугольника GENM с вершинами в точках (1, 1), (4, 1), (4, 5) и (1, 5).	[{"type": "quadrilateral", "name": "GENM"}]
В четырехугольнике UYXS, если ∠A = 120° и ∠B = 60°, найдите величину ∠C.	[{"type": "quadrilateral", "name": "UYXS"}]
Найдите периметр параллелограмма RMGJ, стороны которого равны 7 см и 9 см.	[{"type": "parallelogram", "name": "RMGJ"}]
В квадрате MIZU, если AB = CD и AD = BC, как называется квадрат?	[{"type": "square", "name": "MIZU"}]
Найдите длину диагонали параллелограмма TBKN, стороны которого равны 19 см и 23 см.	[{"type": "parallelogram", "name": "TBKN"}]
Как называется квадрат XFKA, у которого все стороны одинаковой длины и все углы прямые?	[{"type": "square", "name": "XFKA"}]
Найдите величину ∠C в параллелограмме DPHL, если ∠A = 45°.	[{"type": "parallelogram", "name": "DPHL"}]
Определите периметр прямоугольного треугольника ZUX со сторонами 22 см и 24 см и разностороннего треугольника GQS со сторонами 24 см, 26 см и 30 см	[{"type": "triangle", "name": "ZUX"}, {"type": "triangle", "name": "GQS"}]
Найдите площадь прямоугольного треугольника WJK Пифагора с длиной катетов 3 и 4 единицы	[{"type": "triangle", "name": "WJK"}]
Докажите, что диагонали квадрата VPRO являются взаимно перпендикулярными биссектрисами.	[{"type": "square", "name": "VPRO"}]
Найдите величину ∠B в параллелограмме LROY, если ∠A = 60°.	[{"type": "parallelogram", "name": "LROY"}]
Докажите, что диагонали квадрата XMDF пересекаются и делятся пополам под углом 90°.	[{"type": "square", "name": "XMDF"}]
Докажите, что диагонали четырехугольника WREK не обязательно являются взаимно перпендикулярными биссектрисами.	[{"type": "quadrilateral", "name": "WREK"}]
Определите самую длинную сторону треугольника ASB, учитывая, что его углы относятся как 4:5:6.	[{"type": "triangle", "name": "ASB"}]
Определите, является ли треугольник FIE равносторонним, если все три угла равны.	[{"type": "triangle", "name": "FIE"}]
В параллелограмме EIZT, если ∠A = 70°, найдите величину ∠B.	[{"type": "parallelogram", "name": "EIZT"}]
Как называется четырехугольник PRCB, если ∠A = ∠C и ∠B = ∠D?	[{"type": "quadrilateral", "name": "PRCB"}]
Найдите площадь трапеции DRJF с вершинами в точках (0, 0), (8, 0), (10, 12) и (0, 12).	[{"type": "trapezoid", "name": "DRJF"}]
Докажите, что противоположные стороны четырехугольника SQAB не обязательно параллельны.	[{"type": "quadrilateral", "name": "SQAB"}]
Найдите периметр равнобедренного треугольника IDL с основанием 9 см и равными сторонами 7 см, а также остроугольного треугольника MOC с углами 30°, 60° и 90°	[{"type": "triangle", "name": "IDL"}, {"type": "triangle", "name": "MOC"}]
Докажите, что сумма внутренних углов четырехугольника EIYK всегда равна 360°.	[{"type": "quadrilateral", "name": "EIYK"}]
Докажите, что диагонали трапеции GQLS пересекаются под углом 90°.	[{"type": "trapezoid", "name": "GQLS"}]
Какова площадь параллелограмма IHAC, основание которого равно 12 см, а высота — 9 см?	[{"type": "parallelogram", "name": "IHAC"}]
Найдите величину ∠C в трапеции PATN, если ∠A = 110°.	[{"type": "trapezoid", "name": "PATN"}]
Как называется четырехугольник HZEQ, у которого все стороны имеют одинаковую длину?	[{"type": "quadrilateral", "name": "HZEQ"}]
Найдите длину диагонали параллелограмма HLKV, стороны которого равны 10 см и 12 см.	[{"type": "parallelogram", "name": "HLKV"}]
Докажите, что диагонали параллелограмма ZNRJ точкой пересечения образуют угол 90°.	[{"type": "parallelogram", "name": "ZNRJ"}]
Найдите площадь трапеции VDEJ, основания которой равны 12 см и 15 см, а высота 10 см.	[{"type": "trapezoid", "name": "VDEJ"}]
В квадрате DSMQ, если AB = CD и AD = BC, как называется квадрат?	[{"type": "square", "name": "DSMQ"}]
Вычислите периметр разностороннего треугольника PWB со сторонами 48 см, 50 см и 56 см, а также равностороннего треугольника XLY со стороной 44 см	[{"type": "triangle", "name": "PWB"}, {"type": "triangle", "name": "XLY"}]
В квадрате OHKY, если ∠A = 90°, найдите величины оставшихся трех углов.	[{"type": "square", "name": "OHKY"}]
Найдите периметр трапеции IHFV, основания которой равны 18 см и 20 см, а высота 14 см.	[{"type": "trapezoid", "name": "IHFV"}]
Как называется четырехугольник WJES, если AB=CD и AD=BC?	[{"type": "quadrilateral", "name": "WJES"}]
Найдите периметр четырехугольника QHDU со сторонами длиной 16 см, 18 см, 20 см и 22 см.	[{"type": "quadrilateral", "name": "QHDU"}]
Найдите высоту остроугольного треугольника TMC с углами 45°, 60° и 75°, а также равнобедренного треугольника LDG с основанием 82 см и равными сторонами 80 см	[{"type": "triangle", "name": "TMC"}, {"type": "triangle", "name": "LDG"}]
Найдите величину ∠C в трапеции CQPR, если ∠A = 100°.	[{"type": "trapezoid", "name": "CQPR"}]
Найдите величину ∠A в квадрате FZUA, если диагонали AC и BD пересекаются под углом 90°.	[{"type": "square", "name": "FZUA"}]
В квадрате UYEF, если AB = CD и AD = BC, как называется квадрат?	[{"type": "square", "name": "UYEF"}]
Вычислите высоту тупоугольного треугольника PYH с длиной основания 13 единиц и углом 120 градусов	[{"type": "triangle", "name": "PYH"}]
Найдите периметр четырехугольника JRHQ со сторонами длиной 18 см, 20 см, 22 см и 24 см.	[{"type": "quadrilateral", "name": "JRHQ"}]
Найдите периметр параллелограмма MRJW, стороны которого равны 10 см и 12 см.	[{"type": "parallelogram", "name": "MRJW"}]
Определите периметр тупоугольного треугольника QIF со сторонами 98 см, 100 см и 126 см и остроугольного треугольника ACS с углами 30°, 60° и 90°	[{"type": "triangle", "name": "QIF"}, {"type": "triangle", "name": "ACS"}]
Как называется четырехугольник AKON, у которого все углы прямые и все стороны разной длины?	[{"type": "quadrilateral", "name": "AKON"}]
Определите площадь тупоугольного треугольника LPD со сторонами 25 см, 27 см и 30 см, а также прямоугольного треугольника XHS с катетами 25 см и 35 см	[{"type": "triangle", "name": "LPD"}, {"type": "triangle", "name": "XHS"}]
Найдите площадь тупоугольного треугольника KVH с углами 100°, 40° и 40°, а также равнобедренного треугольника DQP с основанием 20 см и равными сторонами 18 см	[{"type": "triangle", "name": "KVH"}, {"type": "triangle", "name": "DQP"}]
В квадрате VWQX, если AB = CD и AD = BC, как называется квадрат?	[{"type": "square", "name": "VWQX"}]
Определите угол между двумя сторонами треугольника EKM длиной 5 и 12 единиц и внутренним углом 60 градусов	[{"type": "triangle", "name": "EKM"}]
Определите площадь прямоугольного треугольника SJD с катетами 35 см и 42 см, а также остроугольного треугольника WKL с углами 30°, 60° и 90°	[{"type": "triangle", "name": "SJD"}, {"type": "triangle", "name": "WKL"}]
Какова площадь трапеции PVED, основания которой равны 20 см и 22 см, а высота 16 см?	[{"type": "trapezoid", "name": "PVED"}]
Найдите длину диагонали трапеции PRUA, основания которой равны 16 см и 18 см, а высота 10 см.	[{"type": "trapezoid", "name": "PRUA"}]
Как называется параллелограмм KUDB, у которого все стороны имеют одинаковую длину и все внутренние углы имеют одинаковую величину?	[{"type": "parallelogram", "name": "KUDB"}]
Найдите длину диагонали четырехугольника RNZS, стороны которого равны 5 см, 6 см и 8 см.	[{"type": "quadrilateral", "name": "RNZS"}]
Какова площадь трапеции TZLX, основания которой равны 25 см и 28 см, а высота 20 см?	[{"type": "trapezoid", "name": "TZLX"}]
Как называется трапеция CWOL, у которой все углы прямые?	[{"type": "trapezoid", "name": "CWOL"}]
В трапеции VHUA, если AB = CD и AD = BC, как называется трапеция?	[{"type": "trapezoid", "name": "VHUA"}]
Найдите периметр квадрата IQTE со стороной 60 см.	[{"type": "square", "name": "IQTE"}]
Вычислите высоту равностороннего треугольника XZF со стороной 20 см и разностороннего треугольника WNS со сторонами 18 см, 22 см и 25 см	[{"type": "triangle", "name": "XZF"}, {"type": "triangle", "name": "WNS"}]
Найдите длину диагонали четырехугольника BLHE, стороны которого имеют длину 4 см, 6 см и 8 см.	[{"type": "quadrilateral", "name": "BLHE"}]
Найдите длину диагонали квадрата KCSH со стороной 15 см.	[{"type": "square", "name": "KCSH"}]
Докажите, что диагонали квадрата RWQF пересекаются и делятся пополам под углом 90°.	[{"type": "square", "name": "RWQF"}]
Найдите площадь треугольника SKC, если его стороны равны 5 см, 12 см и 13 см.	[{"type": "triangle", "name": "SKC"}]
Как называется четырехугольник NLAR с двумя парами параллельных сторон?	[{"type": "quadrilateral", "name": "NLAR"}]
Найдите периметр квадрата HOFN со стороной 25 см.	[{"type": "square", "name": "HOFN"}]
Найдите периметр равнобедренного треугольника PQG с основанием 54 см и равными сторонами 52 см, а также тупоугольного треугольника WVY со сторонами 62 см, 64 см и 74 см	[{"type": "triangle", "name": "PQG"}, {"type": "triangle", "name": "WVY"}]
В квадрате BPAW, если ∠A = 90°, найдите меру ∠D.	[{"type": "square", "name": "BPAW"}]
Вычислите периметр дельты CLB, если стороны равны 4 см, 5 см и 7 см.	[{"type": "triangle", "name": "CLB"}]
В квадрате GKHU, если ∠A = 90°, найдите величину ∠B.	[{"type": "square", "name": "GKHU"}]
Определите площадь разностороннего треугольника MYV со сторонами длиной 5 см, 12 см и 13 см.	[{"type": "triangle", "name": "MYV"}]
Вычислите площадь равнобедренного треугольника EXM с основанием 12 см и равными сторонами 10 см, а также равностороннего треугольника BRU со стороной 15 см	[{"type": "triangle", "name": "EXM"}, {"type": "triangle", "name": "BRU"}]
Как называется параллелограмм IAQJ, если AB = CD и AD = BC?	[{"type": "parallelogram", "name": "IAQJ"}]
В квадрате VSGO, если AB = BC = CD = DA, найдите меру ∠C.	[{"type": "square", "name": "VSGO"}]
Найдите величину ∠C в трапеции FPID, если ∠A = 100°.	[{"type": "trapezoid", "name": "FPID"}]
Вычислите периметр разностороннего треугольника JSU со сторонами 28 см, 30 см и 32 см, а также равностороннего треугольника HPM со стороной 26 см	[{"type": "triangle", "name": "JSU"}, {"type": "triangle", "name": "HPM"}]
Найдите периметр трапеции LCQG, основания которой равны 25 см и 28 см, а высота 20 см.	[{"type": "trapezoid", "name": "LCQG"}]
Найдите периметр трапеции GXBI, основания которой равны 22 см и 25 см, а высота — 18 см.	[{"type": "trapezoid", "name": "GXBI"}]
В квадрате WOGE, если AB = BC = CD = DA, найдите меру ∠C.	[{"type": "square", "name": "WOGE"}]
Найдите площадь остроугольного треугольника MEH с углами 45°, 60° и 75°, а также равнобедренного треугольника ZKG с основанием 5 см и равными сторонами 6 см	[{"type": "triangle", "name": "MEH"}, {"type": "triangle", "name": "ZKG"}]
Определите гипотенузу прямоугольного треугольника YJG с катетами 48 см и 56 см и тупоугольного треугольника BXC с углами 115°, 40° и 25°	[{"type": "triangle", "name": "YJG"}, {"type": "triangle", "name": "BXC"}]
Вычислите периметр разностороннего треугольника BQE со сторонами 72 см, 74 см и 86 см, а также равностороннего треугольника XLY со стороной 70 см	[{"type": "triangle", "name": "BQE"}, {"type": "triangle", "name": "XLY"}]
Найдите величину ∠C в параллелограмме RFWD, если ∠A = 45°.	[{"type": "parallelogram", "name": "RFWD"}]
Найдите уравнения высот треугольника EIO с вершинами (1, 2), (3, 4) и (5, 6)	[{"type": "triangle", "name": "EIO"}]
В параллелограмме FYNH, если AB = 12 см, BC = 15 см, CD = 12 см и DA = 15 см, найдите величину ∠A.	[{"type": "parallelogram", "name": "FYNH"}]
Докажите, что диагонали четырехугольника NCPE точкой пересечения делятся пополам под углом 90°.	[{"type": "quadrilateral", "name": "NCPE"}]
Какова сумма внутренних углов параллелограмма ABOU, один из углов которого равен 90°?	[{"type": "parallelogram", "name": "ABOU"}]
Как называется параллелограмм REPQ, если ∠A = 90° в параллелограмме REPQ?	[{"type": "parallelogram", "name": "REPQ"}]
Вычислите периметр разностороннего треугольника CWJ со сторонами 94 см, 96 см и 118 см, а также равностороннего треугольника OAU со стороной 92 см	[{"type": "triangle", "name": "CWJ"}, {"type": "triangle", "name": "OAU"}]
Найдите длину диагонали четырехугольника PYFU со сторонами 4 см, 6 см и 8 см.	[{"type": "quadrilateral", "name": "PYFU"}]
Какова площадь четырехугольника CQSL, основание которого равно 16 см, а высота — 14 см?	[{"type": "quadrilateral", "name": "CQSL"}]
Найдите площадь трапеции QIES, основания которой равны 15 см и 18 см, а высота 12 см.	[{"type": "trapezoid", "name": "QIES"}]
Найдите периметр квадрата UYVJ со стороной 15 см.	[{"type": "square", "name": "UYVJ"}]
Докажите, что диагонали квадрата SJLK пересекаются и делятся пополам под углом 90°.	[{"type": "square", "name": "SJLK"}]
Как называется четырехугольник GOWB, если AB = CD и AD = BC?	[{"type": "quadrilateral", "name": "GOWB"}]
Определить вершины равностороннего треугольника MKV, вписанного в окружность радиуса 5 единиц	[{"type": "triangle", "name": "MKV"}]
Найдите периметр трапеции YZQP, основания которой равны 15 см и 20 см, а высота 12 см.	[{"type": "trapezoid", "name": "YZQP"}]
Найдите периметр квадрата ATIF со стороной 10 см.	[{"type": "square", "name": "ATIF"}]
Определите площадь треугольника JNE со сторонами длиной 7, 8 и 9 единиц по формуле Герона	[{"type": "triangle", "name": "JNE"}]
Каковы углы треугольника JIG, который также является прямоугольным?	[{"type": "triangle", "name": "JIG"}]
Определите сумму внутренних углов остроугольного треугольника IJP с углами 45°, 60° и 75° и равностороннего треугольника BCA со стороной 38 см	[{"type": "triangle", "name": "IJP"}, {"type": "triangle", "name": "BCA"}]
Докажите, что диагонали трапеции RXQS пересекаются под углом 90°.	[{"type": "trapezoid", "name": "RXQS"}]
Как называется квадрат HMPD, у которого все углы прямые?	[{"type": "square", "name": "HMPD"}]
Найдите площадь параллелограмма SAUX, основание которого равно 18 см, а высота — 15 см.	[{"type": "parallelogram", "name": "SAUX"}]
В квадрате BVMP, если AB = BC = CD = DA, найдите меру ∠A.	[{"type": "square", "name": "BVMP"}]
В параллелограмме RWYB, если AB = CD, как называется параллелограмм?	[{"type": "parallelogram", "name": "RWYB"}]
Найдите площадь трапеции VIBG, основания которой равны 22 см и 25 см, а высота 18 см.	[{"type": "trapezoid", "name": "VIBG"}]
Определите, является ли треугольник AXQ равнобедренным, если угол при основании равен 50°.	[{"type": "triangle", "name": "AXQ"}]
Вычислите длину медианы от вершины B в треугольнике NLS со сторонами длиной 3, 4 и 5 единиц	[{"type": "triangle", "name": "NLS"}]
Найдите величину ∠A в квадрате LTOX, если диагонали AC и BD пересекаются под углом 90°.	[{"type": "square", "name": "LTOX"}]
В квадрате DQWX, если ∠A = 90°, найдите величину ∠B.	[{"type": "square", "name": "DQWX"}]
Найдите длину диагонали четырехугольника HCKN со сторонами 6 см, 8 см и 10 см.	[{"type": "quadrilateral", "name": "HCKN"}]
В параллелограмме WLYS, если AB = 18 см, BC = 21 см, CD = 18 см и DA = 21 см, найдите величину ∠A.	[{"type": "parallelogram", "name": "WLYS"}]
Найдите величину ∠C в четырехугольнике SWKZ, если ∠A = 90°.	[{"type": "quadrilateral", "name": "SWKZ"}]
Докажите, что диагонали квадрата PBGS пересекаются и делятся пополам под углом 90°.	[{"type": "square", "name": "PBGS"}]
Определите площадь тупоугольного треугольника NKP со сторонами 90 см, 92 см и 114 см, а также прямоугольного треугольника VQF с катетами 92 см и 120 см	[{"type": "triangle", "name": "NKP"}, {"type": "triangle", "name": "VQF"}]
Если стороны треугольника NST относятся как 3:4:5, найдите длину самой длинной стороны, если периметр равен 50 см.	[{"type": "triangle", "name": "NST"}]
В квадрате NIGX, если ∠A = 90°, найдите меру ∠D.	[{"type": "square", "name": "NIGX"}]
В четырехугольнике APUG, если ∠A = 80° и ∠B = 70°, найдите сумму оставшихся двух углов.	[{"type": "quadrilateral", "name": "APUG"}]
Найдите площадь параллелограмма CAZY с вершинами в точках (0, 0), (5, 0), (5, 8) и (0, 8).	[{"type": "parallelogram", "name": "CAZY"}]
Определите площадь тупоугольного треугольника XNB со сторонами 42 см, 44 см и 50 см, а также прямоугольного треугольника YAM с катетами 45 см и 55 см	[{"type": "triangle", "name": "XNB"}, {"type": "triangle", "name": "YAM"}]
Как называется четырёхугольник PERO, у которого все внутренние углы равны?	[{"type": "quadrilateral", "name": "PERO"}]
В трапеции STVD, если ∠A = 85° и ∠B = 75°, найдите сумму оставшихся двух углов.	[{"type": "trapezoid", "name": "STVD"}]
Найдите величину ∠A в параллелограмме ZVQO, если диагонали AC и BD пересекаются под углом 45°.	[{"type": "parallelogram", "name": "ZVQO"}]
Как называется параллелограмм DNSQ, у которого все стороны имеют одинаковую длину и все внутренние углы имеют одинаковую величину?	[{"type": "parallelogram", "name": "DNSQ"}]
Вычислите периметр разностороннего треугольника PLN со сторонами 28 см, 30 см и 32 см, а также равностороннего треугольника KZM со стороной 26 см	[{"type": "triangle", "name": "PLN"}, {"type": "triangle", "name": "KZM"}]
Вычислите высоту равностороннего треугольника WVB со стороной 18 см и равнобедренного треугольника DQM с основанием 16 см и равными сторонами 14 см	[{"type": "triangle", "name": "WVB"}, {"type": "triangle", "name": "DQM"}]
Вычислите длину высоты из вершины A в треугольнике BGJ со сторонами длиной 11, 12 и 13 единиц и используйте ее, чтобы найти площадь треугольника	[{"type": "triangle", "name": "BGJ"}]
Как называется четырехугольник UZAB, если диагонали AC и BD делят друг друга пополам?	[{"type": "quadrilateral", "name": "UZAB"}]
Найдите величину ∠B в трапеции HLQX, если ∠A = 70°.	[{"type": "trapezoid", "name": "HLQX"}]
Как называется трапеция CXZF, у которой все углы прямые?	[{"type": "trapezoid", "name": "CXZF"}]
Определите площадь прямоугольного треугольника UXS с катетами 58 см и 70 см, а также остроугольного треугольника EMP с углами 30°, 60° и 90°	[{"type": "triangle", "name": "UXS"}, {"type": "triangle", "name": "EMP"}]
Как называется квадрат JOMN, у которого все углы прямые?	[{"type": "square", "name": "JOMN"}]
Как называется четырехугольник ADRM с двумя парами параллельных сторон?	[{"type": "quadrilateral", "name": "ADRM"}]
Найдите величину ∠D в параллелограмме ZEJW, если ∠A = 105°.	[{"type": "parallelogram", "name": "ZEJW"}]
Найдите площадь квадрата MRFY с вершинами в точках (0, 0), (10, 0), (10, 10) и (0, 10).	[{"type": "square", "name": "MRFY"}]
В квадрате CIRU, если ∠A = 90°, найдите величины оставшихся трех углов.	[{"type": "square", "name": "CIRU"}]
Найдите длину стороны равностороннего треугольника GIL, периметр которого равен 60 см.	[{"type": "triangle", "name": "GIL"}]
Найдите величину ∠A в четырехугольнике CQTA, если AB = 15 см, BC = 18 см, CD = 15 см и DA = 18 см.	[{"type": "quadrilateral", "name": "CQTA"}]
Найдите периметр четырехугольника EKJC со сторонами 7 см, 8 см, 9 см и 10 см.	[{"type": "quadrilateral", "name": "EKJC"}]
Вычислите углы треугольника ZEA, если два угла являются дополнительными, а третий угол равен 30°.	[{"type": "triangle", "name": "ZEA"}]
Найдите периметр квадрата XJRB со стороной 32 см.	[{"type": "square", "name": "XJRB"}]
Найдите величину ∠C в четырехугольнике COAT, если ∠A = 100°.	[{"type": "quadrilateral", "name": "COAT"}]
Докажите, что сумма внутренних углов трапеции XLCZ равна 360°.	[{"type": "trapezoid", "name": "XLCZ"}]
Найдите величину ∠B в трапеции AZRH, если ∠A = 70°.	[{"type": "trapezoid", "name": "AZRH"}]
Вычислите высоту равностороннего треугольника VCO со стороной 18 см и равнобедренного треугольника BGP с основанием 16 см и равными сторонами 14 см	[{"type": "triangle", "name": "VCO"}, {"type": "triangle", "name": "BGP"}]
Вычислите высоту равностороннего треугольника SKV со стороной 60 см и разностороннего треугольника CTW со сторонами 62 см, 64 см и 72 см	[{"type": "triangle", "name": "SKV"}, {"type": "triangle", "name": "CTW"}]
Найдите величину ∠B в параллелограмме SDIE, если ∠A = 60°.	[{"type": "parallelogram", "name": "SDIE"}]
Как называется параллелограмм SVFK, у которого все стороны равны и все углы прямые?	[{"type": "parallelogram", "name": "SVFK"}]
Найдите площадь прямоугольного треугольника JRD с катетами 32 см и 40 см, а также равностороннего треугольника VEP со стороной 32 см	[{"type": "triangle", "name": "JRD"}, {"type": "triangle", "name": "VEP"}]
Найдите площадь треугольника LCR, если его стороны равны 7 см, 8 см и 9 см.	[{"type": "triangle", "name": "LCR"}]
Найдите величину ∠A в четырехугольнике FKRG, если AB = 15 см, BC = 18 см, CD = 15 см и DA = 18 см.	[{"type": "quadrilateral", "name": "FKRG"}]
Как называется трапеция URTS, у которой все углы прямые?	[{"type": "trapezoid", "name": "URTS"}]
Найдите периметр равностороннего треугольника URC со стороной 5 см и равнобедренного треугольника TPL с основанием 6 см и равными сторонами 4 см	[{"type": "triangle", "name": "URC"}, {"type": "triangle", "name": "TPL"}]
Вычислите длину высоты из вершины A в треугольнике GJU со сторонами длиной 3, 4 и 5 единиц и найдите ее уравнение, используя точку S(2, 3), лежащую на ней	[{"type": "triangle", "name": "GJU"}]
Определите, является ли треугольник MLX прямоугольным, если его стороны имеют длины 5, 12 и 13 единиц	[{"type": "triangle", "name": "MLX"}]
Найдите длину диагонали квадрата QEVW со стороной 12 см.	[{"type": "square", "name": "QEVW"}]
Найдите периметр квадрата IUQX со стороной 22 см.	[{"type": "square", "name": "IUQX"}]
Определите площадь разностороннего треугольника LMJ со сторонами 3 см, 4 см и 5 см, а также прямоугольного треугольника OAG с катетами 3 см и 4 см	[{"type": "triangle", "name": "LMJ"}, {"type": "triangle", "name": "OAG"}]
Докажите, что противолежащие углы параллелограмма ZFQX равны.	[{"type": "parallelogram", "name": "ZFQX"}]
Найдите высоту равностороннего треугольника VZU с длиной стороны 10 единиц	[{"type": "triangle", "name": "VZU"}]
Найдите периметр четырехугольника FDBZ со сторонами длиной 18 см, 20 см, 22 см и 24 см.	[{"type": "quadrilateral", "name": "FDBZ"}]
Докажите, что сумма внутренних углов квадрата UZKA равна 360°.	[{"type": "square", "name": "UZKA"}]
Какова сумма внутренних углов параллелограмма SXQU, один из углов которого равен 90°?	[{"type": "parallelogram", "name": "SXQU"}]
Как называется четырехугольник FMAQ, у которого все внутренние углы равны?	[{"type": "quadrilateral", "name": "FMAQ"}]
В параллелограмме AHKN, если ∠A = 75°, найдите величину ∠B.	[{"type": "parallelogram", "name": "AHKN"}]
Докажите, что противолежащие углы параллелограмма XDMU являются дополнительными.	[{"type": "parallelogram", "name": "XDMU"}]
Найдите величину ∠B в трапеции GVSP, если ∠A = 75°.	[{"type": "trapezoid", "name": "GVSP"}]
Найдите периметр тупоугольного треугольника IEN со сторонами 12 см, 14 см и 18 см, а также остроугольного треугольника TBC с углами 30°, 60° и 90°	[{"type": "triangle", "name": "IEN"}, {"type": "triangle", "name": "TBC"}]
Найдите периметр треугольника AFB, если углы равны 70°, 80° и 30°.	[{"type": "triangle", "name": "AFB"}]
В трапеции WRKE, если ∠A = 80° и ∠B = 70°, найдите сумму оставшихся двух углов.	[{"type": "trapezoid", "name": "WRKE"}]
Найдите площадь тупоугольного треугольника XWQ с углами 110°, 40° и 30°, а также равнобедренного треугольника ATI с основанием 36 см и равными сторонами 34 см	[{"type": "triangle", "name": "XWQ"}, {"type": "triangle", "name": "ATI"}]
Определите, является ли треугольник TPJ прямоугольным, если гипотенуза равна 13 см, а длина одного катета 12 см.	[{"type": "triangle", "name": "TPJ"}]
Определите, лежит ли точка K(x, y) на описанной окружности треугольника ENM со сторонами длиной 5, 6 и 7 единиц	[{"type": "triangle", "name": "ENM"}]
Вычислите длину высоты из вершины A в треугольнике RAY со сторонами длиной 3, 4 и 5 единиц и используйте ее, чтобы найти длину биссектрисы стороны XY	[{"type": "triangle", "name": "RAY"}]
Докажите, что диагонали квадрата IAMH являются взаимно перпендикулярными биссектрисами.	[{"type": "square", "name": "IAMH"}]
Найдите длину высоты из вершины C в треугольнике WHM со сторонами длиной 7, 8 и 9 единиц	[{"type": "triangle", "name": "WHM"}]
Найдите величину ∠A в трапеции YIXV, если AB = 18 см, BC = 20 см, CD = 18 см и DA = 20 см.	[{"type": "trapezoid", "name": "YIXV"}]
В трапеции ZXMA, если AB = CD и AD = BC, как называется трапеция?	[{"type": "trapezoid", "name": "ZXMA"}]
Найдите площадь четырехугольника HZRL, основание которого равно 8 см, а высота 5 см.	[{"type": "quadrilateral", "name": "HZRL"}]
В квадрате UJIO, если AB = BC = CD = DA, найдите меру ∠A.	[{"type": "square", "name": "UJIO"}]
Какова площадь трапеции VNYU, основания которой равны 18 см и 20 см, а высота 14 см?	[{"type": "trapezoid", "name": "VNYU"}]
Найдите периметр равнобедренного треугольника FDR с основанием 76 см и равными сторонами 74 см, а также тупоугольного треугольника WVJ со сторонами 84 см, 86 см и 104 см	[{"type": "triangle", "name": "FDR"}, {"type": "triangle", "name": "WVJ"}]
Докажите, что диагонали четырехугольника CPZO точкой пересечения делятся пополам тогда и только тогда, когда четырехугольник является параллелограммом.	[{"type": "quadrilateral", "name": "CPZO"}]
Как называется трапеция UADW с двумя парами равных сторон?	[{"type": "trapezoid", "name": "UADW"}]
Найдите длину диагонали четырехугольника GTOY со сторонами 4 см, 6 см и 8 см.	[{"type": "quadrilateral", "name": "GTOY"}]
Определите площадь треугольника LYS со сторонами длиной 7, 8 и 9 единиц, используя правило синуса	[{"type": "triangle", "name": "LYS"}]
Как называется трапеция GMOY, у которой все стороны имеют одинаковую длину?	[{"type": "trapezoid", "name": "GMOY"}]
Определите периметр тупоугольного треугольника VUC со сторонами 50 см, 52 см и 62 см и остроугольного треугольника QOP с углами 30°, 60° и 90°	[{"type": "triangle", "name": "VUC"}, {"type": "triangle", "name": "QOP"}]
В квадрате PKRN, если AB = BC = CD = DA, найдите меру ∠A.	[{"type": "square", "name": "PKRN"}]
В квадрате OKET, если AB = BC = CD = DA, найдите меру ∠A.	[{"type": "square", "name": "OKET"}]
В квадрате BHRI, если ∠A = 90°, найдите величину ∠B.	[{"type": "square", "name": "BHRI"}]
Найдите периметр трапеции ZUAL, основания которой равны 10 см и 12 см, а высота 8 см.	[{"type": "trapezoid", "name": "ZUAL"}]
Найдите площадь четырехугольника IMLO с вершинами (0, 0), (2, 0), (2, 4) и (0, 4).	[{"type": "quadrilateral", "name": "IMLO"}]
Найдите площадь трапеции OJVP с вершинами в точках (0, 0), (15, 0), (18, 20) и (0, 20).	[{"type": "trapezoid", "name": "OJVP"}]
Определите периметр тупоугольного треугольника HSM со сторонами 50 см, 52 см и 62 см и остроугольного треугольника GAR с углами 30°, 60° и 90°	[{"type": "triangle", "name": "HSM"}, {"type": "triangle", "name": "GAR"}]
Определите, является ли треугольник PQD прямоугольным, если гипотенуза равна 20 см, а длина одного катета 15 см.	[{"type": "triangle", "name": "PQD"}]
Определите меру недостающего угла в прямоугольном треугольнике WDR, длина катета которого равна 9 см, а гипотенуза - 20 см.	[{"type": "triangle", "name": "WDR"}]
В параллелограмме UXNH, если ∠A = 30°, найдите величину ∠B.	[{"type": "parallelogram", "name": "UXNH"}]
Докажите, что противоположные стороны трапеции ENBU не обязательно параллельны.	[{"type": "trapezoid", "name": "ENBU"}]
Определите площадь треугольника DFE, образованного прямыми x + y = 3, y = mx + c и x = 0	[{"type": "triangle", "name": "DFE"}]
Найдите периметр четырехугольника LHRW со сторонами 12 см, 15 см, 18 см и 20 см.	[{"type": "quadrilateral", "name": "LHRW"}]
Вычислите площадь равнобедренного треугольника FVG с основанием 84 см и равными сторонами 82 см, а также разностороннего треугольника QWD со сторонами 96 см, 98 см и 122 см	[{"type": "triangle", "name": "FVG"}, {"type": "triangle", "name": "QWD"}]
Найдите площадь трапеции QSIU с вершинами в точках (0, 0), (15, 0), (18, 20) и (0, 20).	[{"type": "trapezoid", "name": "QSIU"}]
Как называется квадрат SXHV, у которого все стороны одинаковой длины и все углы прямые?	[{"type": "square", "name": "SXHV"}]
Найдите длину высоты из вершины B в треугольнике FEB со сторонами длиной 10, 11 и 12 единиц. Используйте эту информацию, чтобы найти длину гипотенузы.	[{"type": "triangle", "name": "FEB"}]
Найдите величину ∠C в четырехугольнике CTZR, если ∠A = 55°.	[{"type": "quadrilateral", "name": "CTZR"}]
Найдите площадь четырехугольника PTUG с вершинами (0, 0), (4, 0), (4, 3) и (0, 3).	[{"type": "quadrilateral", "name": "PTUG"}]
Найдите величину ∠B в трапеции AUSO, если ∠A = 75°.	[{"type": "trapezoid", "name": "AUSO"}]
В квадрате VFRN, если ∠A = 90°, найдите величины оставшихся трех углов.	[{"type": "square", "name": "VFRN"}]
Как называется трапеция HOQX, у которой все стороны имеют одинаковую длину?	[{"type": "trapezoid", "name": "HOQX"}]
Найдите длину медианы трапеции HENO, основания которой равны 14 см и 16 см, а высота — 10 см.	[{"type": "trapezoid", "name": "HENO"}]
Найдите периметр равнобедренного треугольника WZB с основанием 34 см и равными сторонами 32 см, а также тупоугольного треугольника HFM со сторонами 38 см, 40 см и 46 см	[{"type": "triangle", "name": "WZB"}, {"type": "triangle", "name": "HFM"}]
В квадрате DKHR, если AB = CD и AD = BC, как называется квадрат?	[{"type": "square", "name": "DKHR"}]
Найдите периметр трапеции VIPO, основания которой равны 25 см и 28 см, а высота 20 см.	[{"type": "trapezoid", "name": "VIPO"}]
Вычислите площадь треугольника RWI, зная, что его углы равны 40°, 60° и 80°.	[{"type": "triangle", "name": "RWI"}]
Как называется четырехугольник URTW, если AB = CD и AD = BC?	[{"type": "quadrilateral", "name": "URTW"}]
Вычислите длину высоты из вершины A в треугольнике WPM со сторонами длиной 3, 4 и 5 единиц и используйте ее, чтобы найти длину биссектрисы угла A	[{"type": "triangle", "name": "WPM"}]
Найдите площадь квадрата UQGV со стороной 50 см.	[{"type": "square", "name": "UQGV"}]
Докажите, что диагонали четырехугольника YNWK не обязательно являются взаимно перпендикулярными биссектрисами.	[{"type": "quadrilateral", "name": "YNWK"}]
Как называется четырехугольник TLQR, у которого все стороны одинаковой длины и все углы прямые?	[{"type": "quadrilateral", "name": "TLQR"}]
Найдите периметр равнобедренного треугольника IKB с основанием 18 см и равными сторонами 16 см, а также тупоугольного треугольника TCJ со сторонами 20 см, 22 см и 26 см	[{"type": "triangle", "name": "IKB"}, {"type": "triangle", "name": "TCJ"}]
Найдите периметр трапеции RKZG, основания которой равны 18 см и 20 см, а высота 14 см.	[{"type": "trapezoid", "name": "RKZG"}]
Найдите сумму внутренних углов равнобедренного треугольника PSW с основанием 58 см и равными сторонами 56 см, а также разностороннего треугольника ABF со сторонами 70 см, 72 см и 84 см	[{"type": "triangle", "name": "PSW"}, {"type": "triangle", "name": "ABF"}]
Как называется параллелограмм PFMS, если AB = CD и AD = BC?	[{"type": "parallelogram", "name": "PFMS"}]
Докажите, что противолежащие углы параллелограмма VLWH являются дополнительными.	[{"type": "parallelogram", "name": "VLWH"}]
Найдите площадь трапеции JAEY, основания которой равны 12 см и 15 см, а высота 10 см.	[{"type": "trapezoid", "name": "JAEY"}]
Докажите, что диагонали четырехугольника ZQVP не обязательно являются взаимно перпендикулярными биссектрисами.	[{"type": "quadrilateral", "name": "ZQVP"}]
Докажите, что сумма внутренних углов четырехугольника LOUY всегда равна 360°.	[{"type": "quadrilateral", "name": "LOUY"}]
Чему равна сумма внутренних углов четырёхугольника TEAD?	[{"type": "quadrilateral", "name": "TEAD"}]
Докажите, что сумма внутренних углов квадрата NHTJ равна 360°.	[{"type": "square", "name": "NHTJ"}]
Какова площадь параллелограмма EMFC, основание которого равно 16 см, а высота — 18 см?	[{"type": "parallelogram", "name": "EMFC"}]
Найдите площадь четырехугольника MBVL, основание которого равно 20 см, а высота — 18 см.	[{"type": "quadrilateral", "name": "MBVL"}]
Вычислите площадь равнобедренного треугольника XIL с основанием 12 см и равными сторонами 10 см, а также равностороннего треугольника VTW со стороной 15 см	[{"type": "triangle", "name": "XIL"}, {"type": "triangle", "name": "VTW"}]
Найдите площадь четырехугольника IHXC с вершинами (0, 0), (2, 0), (2, 4) и (0, 4).	[{"type": "quadrilateral", "name": "IHXC"}]
Найдите длину диагонали квадрата QDGU со стороной 40 см.	[{"type": "square", "name": "QDGU"}]
Как называется четырехугольник GQME, если AB = CD и AD = BC?	[{"type": "quadrilateral", "name": "GQME"}]
Найдите периметр трапеции KVGH, основания которой равны 28 см и 30 см, а высота — 22 см.	[{"type": "trapezoid", "name": "KVGH"}]
В квадрате PZMX, если ∠A = 90°, найдите величину ∠B.	[{"type": "square", "name": "PZMX"}]
Найдите величину ∠C в параллелограмме ZMWG, если диагонали AC и BD пересекаются под углом 45°.	[{"type": "parallelogram", "name": "ZMWG"}]
В квадрате XRHO, если AB = BC = CD = DA, найдите меру ∠A.	[{"type": "square", "name": "XRHO"}]
Определите площадь треугольника BPC со сторонами длиной 5, 6 и 7 единиц по формуле Герона.	[{"type": "triangle", "name": "BPC"}]
Определите периметр тупоугольного треугольника CSB со сторонами 30 см, 32 см и 38 см и остроугольного треугольника XMK с углами 30°, 60° и 90°	[{"type": "triangle", "name": "CSB"}, {"type": "triangle", "name": "XMK"}]
Вычислите периметр треугольника IFN, если углы равны 60°, 70° и 50°.	[{"type": "triangle", "name": "IFN"}]
Найдите величину ∠B в четырехугольнике UVDK, если ∠A = 70°.	[{"type": "quadrilateral", "name": "UVDK"}]
Как называется четырёхугольник HKMD, у которого все внутренние углы равны?	[{"type": "quadrilateral", "name": "HKMD"}]
Докажите, что диагонали четырехугольника RUIK точкой пересечения делятся пополам тогда и только тогда, когда четырехугольник является параллелограммом.	[{"type": "quadrilateral", "name": "RUIK"}]
Найдите площадь параллелограмма DSMA с вершинами в точках (0, 0), (4, 0), (4, 6) и (0, 6).	[{"type": "parallelogram", "name": "DSMA"}]
В четырехугольнике TFPN, если AB = 8 см, BC = 10 см, CD = 12 см, DA = 14 см и ∠A = 90°, найдите меру ∠C.	[{"type": "quadrilateral", "name": "TFPN"}]
В квадрате AKQO, если AB = CD и AD = BC, как называется квадрат?	[{"type": "square", "name": "AKQO"}]
Вычислите сумму внутренних углов равностороннего треугольника OMD со стороной 12 см и равнобедренного треугольника CRB с основанием 10 см и равными сторонами 8 см	[{"type": "triangle", "name": "OMD"}, {"type": "triangle", "name": "CRB"}]
В четырехугольнике NGTH, если ∠A = ∠C и ∠B = ∠D, как называется четырехугольник?	[{"type": "quadrilateral", "name": "NGTH"}]
Найдите площадь квадрата BLDQ с вершинами в точках (0, 0), (12, 0), (12, 12) и (0, 12).	[{"type": "square", "name": "BLDQ"}]
Как называется четырехугольник RQKG, если AC = BD?	[{"type": "quadrilateral", "name": "RQKG"}]
Найдите сумму внутренних углов равностороннего треугольника GNH со стороной 30 см и прямоугольного треугольника FRU со сторонами 30 см и 40 см	[{"type": "triangle", "name": "GNH"}, {"type": "triangle", "name": "FRU"}]
Как называется параллелограмм LJSH, если AB = CD и AD = BC?	[{"type": "parallelogram", "name": "LJSH"}]
Докажите, что противоположные стороны параллелограмма LCFB параллельны.	[{"type": "parallelogram", "name": "LCFB"}]
Как называется четырехугольник KOXA, если ∠A = ∠C и ∠B = ∠D?	[{"type": "quadrilateral", "name": "KOXA"}]
Определите, является ли треугольник ISG прямоугольным, если гипотенуза равна 10 см, а длина одного катета 6 см.	[{"type": "triangle", "name": "ISG"}]
Как называется параллелограмм VNEU, если AB = CD и AD = BC?	[{"type": "parallelogram", "name": "VNEU"}]
Докажите, что сумма внутренних углов трапеции ZQBM равна 360°.	[{"type": "trapezoid", "name": "ZQBM"}]
Докажите, что диагонали параллелограмма AOUI точкой пересечения делятся пополам под прямым углом.	[{"type": "parallelogram", "name": "AOUI"}]
Определите, является ли треугольник NWU остроугольным, если его стороны имеют длины 3, 4 и 5 единиц	[{"type": "triangle", "name": "NWU"}]
Вычислите площадь равнобедренного треугольника MRJ с основанием 84 см и равными сторонами 82 см, а также разностороннего треугольника SCI со сторонами 96 см, 98 см и 122 см	[{"type": "triangle", "name": "MRJ"}, {"type": "triangle", "name": "SCI"}]
Определите, лежит ли точка K(x, y) на описанной окружности треугольника CJZ со сторонами длиной 5, 6 и 7 единиц.	[{"type": "triangle", "name": "CJZ"}]
Докажите, что сумма внутренних углов квадрата TVQO равна 360°.	[{"type": "square", "name": "TVQO"}]
Найдите периметр параллелограмма OTJG, стороны которого равны 9 см и 11 см.	[{"type": "parallelogram", "name": "OTJG"}]
Найдите площадь четырехугольника EFPS, основание которого равно 22 см, а высота — 20 см.	[{"type": "quadrilateral", "name": "EFPS"}]
Вычислите гипотенузу разностороннего треугольника GUN со сторонами 64 см, 66 см и 76 см, а также прямоугольного треугольника ISV с катетами 64 см и 80 см	[{"type": "triangle", "name": "GUN"}, {"type": "triangle", "name": "ISV"}]
В трапеции GOLF, если AB = CD и AD = BC, как называется трапеция?	[{"type": "trapezoid", "name": "GOLF"}]
Докажите, что диагонали параллелограмма UYIE являются взаимно перпендикулярными и серединными.	[{"type": "parallelogram", "name": "UYIE"}]
В трапеции ZWKM, если AB = CD и AD = BC, как называется трапеция?	[{"type": "trapezoid", "name": "ZWKM"}]
Как называется квадрат RZHL, у которого все стороны имеют одинаковую длину?	[{"type": "square", "name": "RZHL"}]
Вычислите гипотенузу разностороннего треугольника AFY со сторонами 40 см, 42 см и 48 см, а также прямоугольного треугольника SZB с катетами 40 см и 50 см	[{"type": "triangle", "name": "AFY"}, {"type": "triangle", "name": "SZB"}]
В квадрате YOXA, если ∠A = 90°, найдите величину ∠B.	[{"type": "square", "name": "YOXA"}]
Найдите сумму внутренних углов разностороннего треугольника BFA со сторонами 35 см, 37 см и 40 см, а также равнобедренного треугольника ZMJ с основанием 30 см и равными сторонами 28 см	[{"type": "triangle", "name": "BFA"}, {"type": "triangle", "name": "ZMJ"}]
Как называется трапеция AVJN, у которой все стороны имеют одинаковую длину?	[{"type": "trapezoid", "name": "AVJN"}]
Найдите площадь квадрата ARXK со стороной 42 см.	[{"type": "square", "name": "ARXK"}]
Найдите величину ∠C в четырехугольнике SLMI, если ∠A = 100°.	[{"type": "quadrilateral", "name": "SLMI"}]
Как называется квадрат WAGQ, у которого все стороны одинаковой длины и все углы прямые?	[{"type": "square", "name": "WAGQ"}]
Найдите высоту остроугольного треугольника ZYI с углами 45°, 60° и 75°, а также равнобедренного треугольника USO с основанием 82 см и равными сторонами 80 см	[{"type": "triangle", "name": "ZYI"}, {"type": "triangle", "name": "USO"}]
Определите периметр прямоугольного треугольника YBV со сторонами 66 см и 76 см и разностороннего треугольника CRK со сторонами 68 см, 70 см и 82 см	[{"type": "triangle", "name": "YBV"}, {"type": "triangle", "name": "CRK"}]
Найдите периметр равнобедренного треугольника MNZ с основанием 54 см и равными сторонами 52 см, а также тупоугольного треугольника HWE со сторонами 62 см, 64 см и 74 см	[{"type": "triangle", "name": "MNZ"}, {"type": "triangle", "name": "HWE"}]
Найдите сумму внутренних углов равнобедренного треугольника BIF с основанием 80 см и равными сторонами 78 см, а также разностороннего треугольника YZC со сторонами 92 см, 94 см и 116 см	[{"type": "triangle", "name": "BIF"}, {"type": "triangle", "name": "YZC"}]
Вычислите высоту тупоугольного треугольника ZLJ с углами 100°, 40° и 40°, а также равностороннего треугольника XDH со стороной 10 см	[{"type": "triangle", "name": "ZLJ"}, {"type": "triangle", "name": "XDH"}]
Вычислите гипотенузу разностороннего треугольника LIA со сторонами 86 см, 88 см и 106 см, а также прямоугольного треугольника QWZ с катетами 86 см и 110 см	[{"type": "triangle", "name": "LIA"}, {"type": "triangle", "name": "QWZ"}]
Найдите длину стороны правильного треугольника WBE, периметр которого равен 24 см.	[{"type": "triangle", "name": "WBE"}]
Вычислите углы треугольника LAS, если два угла являются дополнительными, а третий угол равен 70°.	[{"type": "triangle", "name": "LAS"}]
Найдите длину медианы из вершины C в треугольнике FKA со сторонами длиной 3, 4 и 5 единиц и докажите, что она является высотой треугольника тогда и только тогда, когда это равнобедренный треугольник	[{"type": "triangle", "name": "FKA"}]
Найдите длину медианы из вершины B в треугольнике JXG со сторонами длиной 5, 6 и 7 единиц и докажите, что она является высотой треугольника тогда и только тогда, когда он прямоугольный.	[{"type": "triangle", "name": "JXG"}]
Как называется четырехугольник TIKW, если AB = CD и AD = BC?	[{"type": "quadrilateral", "name": "TIKW"}]
Вычислите недостающую величину угла в треугольнике FVI, если углы относятся как 2:3:4.	[{"type": "triangle", "name": "FVI"}]
Найдите площадь квадрата XCIL со стороной 20 см.	[{"type": "square", "name": "XCIL"}]
В параллелограмме YAFK, если ∠A = 80°, найдите величину ∠B.	[{"type": "parallelogram", "name": "YAFK"}]
Найдите величину ∠A в квадрате MWQB, если диагонали AC и BD пересекаются под углом 90°.	[{"type": "square", "name": "MWQB"}]
Докажите, что сумма внутренних углов четырехугольника QEDA всегда равна 360°.	[{"type": "quadrilateral", "name": "QEDA"}]
Найдите высоту остроугольного треугольника AEN с углами 45°, 60° и 75° и тупоугольного треугольника ZGC с углами 120°, 30° и 30°	[{"type": "triangle", "name": "AEN"}, {"type": "triangle", "name": "ZGC"}]
Определите площадь прямоугольного треугольника DEA с катетами 9 см и 12 см и разностороннего треугольника OWV со сторонами 8 см, 10 см и 14 см	[{"type": "triangle", "name": "DEA"}, {"type": "triangle", "name": "OWV"}]
Найдите периметр параллелограмма XCWA со сторонами длиной 17 см и 22 см.	[{"type": "parallelogram", "name": "XCWA"}]
Докажите, что противолежащие углы параллелограмма HEKV являются дополнительными.	[{"type": "parallelogram", "name": "HEKV"}]
В квадрате RUWD, если ∠A = 90°, найдите величину ∠B.	[{"type": "square", "name": "RUWD"}]
Докажите, что диагонали квадрата VXWG пересекаются и делятся пополам под углом 90°.	[{"type": "square", "name": "VXWG"}]
В параллелограмме TGOA, если ∠A = 75°, найдите величину ∠B.	[{"type": "parallelogram", "name": "TGOA"}]
Найдите площадь квадрата RDEI с вершинами в точках (0, 0), (10, 0), (10, 10) и (0, 10).	[{"type": "square", "name": "RDEI"}]
Докажите, что диагонали четырехугольника SLPR точкой пересечения делятся пополам под углом 90°.	[{"type": "quadrilateral", "name": "SLPR"}]
Найдите длину диагонали параллелограмма FNQJ, стороны которого равны 6 см и 8 см.	[{"type": "parallelogram", "name": "FNQJ"}]
В четырехугольнике KWHV, если AB = 10 см, BC = 12 см, CD = 15 см и DA = 16 см, ∠A = 70°, найдите меру ∠B.	[{"type": "quadrilateral", "name": "KWHV"}]
Вычислите высоту равностороннего треугольника ATL со стороной 66 см и остроугольного треугольника OHW с углами 30°, 60° и 90°	[{"type": "triangle", "name": "ATL"}, {"type": "triangle", "name": "OHW"}]
Найдите периметр квадрата BGOW со стороной 22 см.	[{"type": "square", "name": "BGOW"}]
Определите сумму внутренних углов прямоугольного треугольника JCG со сторонами 12 см и 16 см и разностороннего треугольника XYO со сторонами 14 см, 16 см и 20 см	[{"type": "triangle", "name": "JCG"}, {"type": "triangle", "name": "XYO"}]
Найдите длину диагонали четырехугольника PRKO, стороны которого равны 10 см, 12 см и 14 см.	[{"type": "quadrilateral", "name": "PRKO"}]
Докажите, что диагонали параллелограмма VQWN точкой пересечения делятся пополам под прямым углом.	[{"type": "parallelogram", "name": "VQWN"}]
Вычислите сумму внутренних углов тупоугольного треугольника NAW с углами 120°, 40° и 20° и остроугольного треугольника HMJ с углами 30°, 60° и 90°	[{"type": "triangle", "name": "NAW"}, {"type": "triangle", "name": "HMJ"}]
Найдите величину ∠C в трапеции PDQF, если ∠A = 110°.	[{"type": "trapezoid", "name": "PDQF"}]
Вычислите недостающую величину угла в треугольнике UIS, если углы относятся как 4:5:6.	[{"type": "triangle", "name": "UIS"}]
Найдите величину ∠D в четырехугольнике BMSC, если ∠A = 50°.	[{"type": "quadrilateral", "name": "BMSC"}]
Найдите длину диагонали квадрата OEDK со стороной 30 см.	[{"type": "square", "name": "OEDK"}]
Найдите площадь квадрата DQNV со стороной 50 см.	[{"type": "square", "name": "DQNV"}]
Найдите периметр квадрата ITSP со стороной 20 см.	[{"type": "square", "name": "ITSP"}]
Найдите длину медианы трапеции KYUP, основания которой равны 14 см и 16 см, а высота — 10 см.	[{"type": "trapezoid", "name": "KYUP"}]
Найдите величину ∠A в трапеции HRVM, если диагонали AC и BD пересекаются под углом 60°.	[{"type": "trapezoid", "name": "HRVM"}]
Найдите периметр тупоугольного треугольника NQZ со сторонами 12 см, 14 см и 18 см, а также остроугольного треугольника MAW с углами 30°, 60° и 90°	[{"type": "triangle", "name": "NQZ"}, {"type": "triangle", "name": "MAW"}]
Найдите длину диагонали параллелограмма WSRL, стороны которого равны 12 см и 15 см.	[{"type": "parallelogram", "name": "WSRL"}]
В квадрате MCEN, если ∠A = 90°, найдите величины оставшихся трех углов.	[{"type": "square", "name": "MCEN"}]
Как называется трапеция THYU, у которой все углы прямые?	[{"type": "trapezoid", "name": "THYU"}]
В треугольнике DCI, если высота от вершины P до стороны QR равна 3 см, а площадь 9 см², найдите длину QR.	[{"type": "triangle", "name": "DCI"}]
В квадрате DSBC, если AB = CD и AD = BC, как называется квадрат?	[{"type": "square", "name": "DSBC"}]
Докажите, что сумма внутренних углов трапеции COPZ равна 360°.	[{"type": "trapezoid", "name": "COPZ"}]
Вычислите площадь треугольника BYF, учитывая, что его основание 14 см, а высота 10 см.	[{"type": "triangle", "name": "BYF"}]
Найдите площадь четырехугольника TVKQ, основание которого равно 12 см, а высота — 10 см.	[{"type": "quadrilateral", "name": "TVKQ"}]
Найдите площадь параллелограмма ZDMO, основание которого равно 20 см, а высота — 18 см.	[{"type": "parallelogram", "name": "ZDMO"}]
Если стороны треугольника AHF относятся как 4:5:6, найдите длину самой длинной стороны, если периметр равен 45 см.	[{"type": "triangle", "name": "AHF"}]
Определите гипотенузу прямоугольного треугольника WRL с катетами 48 см и 56 см и тупоугольного треугольника CPI с углами 115°, 40° и 25°	[{"type": "triangle", "name": "WRL"}, {"type": "triangle", "name": "CPI"}]
Найдите площадь квадрата TPUE со стороной 28 см.	[{"type": "square", "name": "TPUE"}]
Найдите периметр параллелограмма PFNC, стороны которого равны 18 см и 24 см.	[{"type": "parallelogram", "name": "PFNC"}]
Если стороны треугольника XRN относятся как 4:5:6, найдите длину самой длинной стороны, если периметр равен 63 см.	[{"type": "triangle", "name": "XRN"}]
Найдите площадь квадрата LGAR с вершинами в точках (0, 0), (30, 0), (30, 30) и (0, 30).	[{"type": "square", "name": "LGAR"}]
Найдите величину ∠B в трапеции FTGQ, если ∠A = 70°.	[{"type": "trapezoid", "name": "FTGQ"}]
Определите площадь прямоугольного треугольника NAH с катетами 9 см и 12 см и разностороннего треугольника TKE со сторонами 8 см, 10 см и 14 см	[{"type": "triangle", "name": "NAH"}, {"type": "triangle", "name": "TKE"}]
Определите площадь треугольника DLE со сторонами длиной 6, 8 и 10 единиц по формуле Герона	[{"type": "triangle", "name": "DLE"}]
Как называется четырехугольник UMFZ, если AB = CD и AD = BC?	[{"type": "quadrilateral", "name": "UMFZ"}]
Найдите площадь трапеции OYLS, основания которой равны 28 см и 30 см, а высота 22 см.	[{"type": "trapezoid", "name": "OYLS"}]
Найдите длину диагонали параллелограмма FHKU, стороны которого равны 12 см и 15 см.	[{"type": "parallelogram", "name": "FHKU"}]
Найдите периметр четырехугольника RUGA со сторонами 3 см, 5 см, 7 см и 9 см.	[{"type": "quadrilateral", "name": "RUGA"}]
Найдите площадь тупоугольного треугольника CHB с углами 115°, 40° и 25°, а также равнобедренного треугольника JAI с основанием 56 см и равными сторонами 54 см	[{"type": "triangle", "name": "CHB"}, {"type": "triangle", "name": "JAI"}]
Найдите длину медианы из вершины B в треугольнике BYV со сторонами длиной 5, 6 и 7 единиц и докажите, что она является высотой треугольника тогда и только тогда, когда он прямоугольный	[{"type": "triangle", "name": "BYV"}]
Какова сумма внутренних углов параллелограмма QRMO, один из углов которого равен 90°?	[{"type": "parallelogram", "name": "QRMO"}]
Вычислите углы треугольника FBT, если два угла равны и каждый равен 60°.	[{"type": "triangle", "name": "FBT"}]
В треугольнике QDS, если углы относятся как 1:2:3, найдите величину среднего угла.	[{"type": "triangle", "name": "QDS"}]
Найдите площадь треугольника FTC, если его стороны равны 10 см, 12 см и 15 см.	[{"type": "triangle", "name": "FTC"}]
Вычислите площадь равнобедренного треугольника OLK с основанием 28 см и равными сторонами 26 см, а также разностороннего треугольника CXB со сторонами 30 см, 32 см и 36 см	[{"type": "triangle", "name": "OLK"}, {"type": "triangle", "name": "CXB"}]
Найдите величину ∠A в параллелограмме CLKJ, если диагонали AC и BD пересекаются под углом 60°.	[{"type": "parallelogram", "name": "CLKJ"}]
В трапеции HBUA, если AB = CD и AD = BC, как называется трапеция?	[{"type": "trapezoid", "name": "HBUA"}]
Вычислите площадь равнобедренного треугольника XAK с основанием 42 см и равными сторонами 40 см, а также разностороннего треугольника MSR со сторонами 50 см, 52 см и 60 см	[{"type": "triangle", "name": "XAK"}, {"type": "triangle", "name": "MSR"}]
Найдите длину диагонали параллелограмма LYAX, стороны которого равны 15 см и 18 см.	[{"type": "parallelogram", "name": "LYAX"}]
Определите, является ли треугольник CPA равнобедренным, если оба угла при основании равны 35°.	[{"type": "triangle", "name": "CPA"}]
Найдите величину ∠C в четырехугольнике LDOK, если ∠A = 90°.	[{"type": "quadrilateral", "name": "LDOK"}]
Найдите величину ∠D в параллелограмме PXAK, если ∠A = 60°.	[{"type": "parallelogram", "name": "PXAK"}]
Найдите длину высоты из вершины C в треугольнике RKB со сторонами длиной 7, 8 и 9 единиц. Используйте эту информацию, чтобы найти высоту треугольника.	[{"type": "triangle", "name": "RKB"}]
Докажите, что длины противоположных сторон параллелограмма MFGU равны.	[{"type": "parallelogram", "name": "MFGU"}]
Найдите площадь квадрата ISVC с вершинами в точках (0, 0), (40, 0), (40, 40) и (0, 40).	[{"type": "square", "name": "ISVC"}]
Определите гипотенузу остроугольного треугольника XRB с углами 45°, 60° и 75° и разностороннего треугольника LAH со сторонами 102 см, 104 см и 134 см	[{"type": "triangle", "name": "XRB"}, {"type": "triangle", "name": "LAH"}]
Докажите, что диагонали трапеции UATE не обязательно являются взаимно перпендикулярными биссектрисами.	[{"type": "trapezoid", "name": "UATE"}]
Определите площадь треугольника IQE со сторонами длиной 5, 6 и 7 единиц, используя Закон касательных	[{"type": "triangle", "name": "IQE"}]
В квадрате SLWI, если ∠A = 90°, найдите величины оставшихся трех углов.	[{"type": "square", "name": "SLWI"}]
Какова площадь квадрата ICWZ со стороной 20 см?	[{"type": "square", "name": "ICWZ"}]
Определите, подобен ли треугольник TZW треугольнику UVW со сторонами длиной 5:3:4 и 6:4:5 соответственно	[{"type": "triangle", "name": "TZW"}]
Определите гипотенузу прямоугольного треугольника LBV с катетами 94 см и 118 см и тупоугольного треугольника WYG с углами 125°, 40° и 15°	[{"type": "triangle", "name": "LBV"}, {"type": "triangle", "name": "WYG"}]
Вычислите гипотенузу разностороннего треугольника WQC со сторонами 64 см, 66 см и 76 см, а также прямоугольного треугольника ZFT с катетами 64 см и 80 см	[{"type": "triangle", "name": "WQC"}, {"type": "triangle", "name": "ZFT"}]
Как называется четырехугольник MRFN с двумя парами равных сторон?	[{"type": "quadrilateral", "name": "MRFN"}]
Как называется параллелограмм ABCO, у которого все стороны равны и все углы прямые?	[{"type": "parallelogram", "name": "ABCO"}]
Докажите, что сумма внутренних углов трапеции ILUC равна 360°.	[{"type": "trapezoid", "name": "ILUC"}]
Как называется трапеция TWZL, у которой все углы прямые?	[{"type": "trapezoid", "name": "TWZL"}]
Какова площадь параллелограмма KGOU, основание которого равно 12 см, а высота — 9 см?	[{"type": "parallelogram", "name": "KGOU"}]
Найдите величину ∠B в четырехугольнике NRXO, если ∠A = 70°.	[{"type": "quadrilateral", "name": "NRXO"}]
Найдите периметр параллелограмма TFJQ, стороны которого равны 5 см и 7 см.	[{"type": "parallelogram", "name": "TFJQ"}]
Найдите величину ∠D в параллелограмме IBZT, если ∠A = 105°.	[{"type": "parallelogram", "name": "IBZT"}]
Как называется параллелограмм WAFH, если AB = CD и AD = BC?	[{"type": "parallelogram", "name": "WAFH"}]
Определите, лежит ли точка P(x, y) внутри, снаружи или на границе треугольника PNA с вершинами (2, 3), (5, 6) и (8, 1).	[{"type": "triangle", "name": "PNA"}]
Найдите площадь параллелограмма SPNL с вершинами в точках (0, 0), (5, 0), (5, 8) и (0, 8).	[{"type": "parallelogram", "name": "SPNL"}]
Докажите, что противоположные стороны параллелограмма SWRK равны.	[{"type": "parallelogram", "name": "SWRK"}]
В квадрате VXCW, если ∠A = 90°, найдите меру ∠D.	[{"type": "square", "name": "VXCW"}]
Как называется четырехугольник RFPA, у которого все углы прямые?	[{"type": "quadrilateral", "name": "RFPA"}]
Найдите площадь прямоугольного треугольника GRJ с катетами 100 см и 130 см, а также равностороннего треугольника YCQ со стороной 100 см	[{"type": "triangle", "name": "GRJ"}, {"type": "triangle", "name": "YCQ"}]
Найдите величину ∠B в трапеции XZVR, если ∠A = 90°.	[{"type": "trapezoid", "name": "XZVR"}]
Как называется параллелограмм JXSD, если ∠A = 90° в параллелограмме JXSD?	[{"type": "parallelogram", "name": "JXSD"}]
Найдите площадь четырехугольника ZSHE, основание которого равно 10 см, а высота — 8 см.	[{"type": "quadrilateral", "name": "ZSHE"}]
Как называется трапеция FAKW, у которой все стороны имеют одинаковую длину?	[{"type": "trapezoid", "name": "FAKW"}]
Найдите длину медианы из вершины C в треугольнике KAI со сторонами длиной 5, 6 и 7 единиц и докажите, что она делит пополам угол между сторонамиEF и DF тогда и только тогда, когда треугольник является прямоугольным	[{"type": "triangle", "name": "KAI"}]
Определите площадь треугольника PAZ со сторонами длиной 3, 4 и 5 единиц с помощью правила косинуса	[{"type": "triangle", "name": "PAZ"}]
Найдите длину медианы из вершины B в треугольнике AIC с сторонами длины 10, 11 и 12 единиц и докажите, что он разделяет угол между сторонами YX и ZX	[{"type": "triangle", "name": "AIC"}]
Докажите, что диагонали квадрата BRQF являются взаимно перпендикулярными биссектрисами.	[{"type": "square", "name": "BRQF"}]
Как называется четырехугольник FJZK с двумя парами равных сторон?	[{"type": "quadrilateral", "name": "FJZK"}]
Найдите величину ∠A в трапеции BADT, если AB = 20 см, BC = 22 см, CD = 20 см и DA = 22 см.	[{"type": "trapezoid", "name": "BADT"}]
Найдите длину диагонали трапеции HLGJ, основания которой равны 20 см и 22 см, а высота — 14 см.	[{"type": "trapezoid", "name": "HLGJ"}]
Найдите периметр параллелограмма MKNX, стороны которого равны 5 см и 7 см.	[{"type": "parallelogram", "name": "MKNX"}]
Докажите, что диагонали квадрата EKGB пересекаются и делятся пополам под углом 90°.	[{"type": "square", "name": "EKGB"}]
Найдите периметр квадрата JTVI со стороной 25 см.	[{"type": "square", "name": "JTVI"}]
Найдите площадь трапеции QXFJ, основания которой равны 28 см и 30 см, а высота 22 см.	[{"type": "trapezoid", "name": "QXFJ"}]
Найдите периметр четырехугольника YKUO со сторонами длиной 14 см, 16 см, 18 см и 20 см.	[{"type": "quadrilateral", "name": "YKUO"}]
Определите, является ли треугольник SND прямоугольным, если гипотенуза равна 15 см, а длина одного катета 8 см.	[{"type": "triangle", "name": "SND"}]
Найдите периметр четырехугольника OJKU со сторонами 3 см, 5 см, 7 см и 9 см.	[{"type": "quadrilateral", "name": "OJKU"}]
Найдите периметр параллелограмма YPUH, стороны которого равны 12 см и 15 см.	[{"type": "parallelogram", "name": "YPUH"}]
Найдите площадь четырехугольника ZVTY, основание которого равно 12 см, а высота — 10 см.	[{"type": "quadrilateral", "name": "ZVTY"}]
Как называется трапеция LOBC с двумя парами равных сторон?	[{"type": "trapezoid", "name": "LOBC"}]
Как называется параллелограмм MLDZ, у которого все стороны равны и все углы прямые?	[{"type": "parallelogram", "name": "MLDZ"}]
В четырехугольнике WPRE, если ∠A = 85° и ∠B = 75°, найдите сумму оставшихся двух углов.	[{"type": "quadrilateral", "name": "WPRE"}]
Найдите периметр квадрата SAWH со стороной 10 см.	[{"type": "square", "name": "SAWH"}]
Найдите длину стороны равностороннего треугольника ECB, периметр которого равен 48 см.	[{"type": "triangle", "name": "ECB"}]
Найдите величину ∠B в параллелограмме WIAV, если ∠A = 60°.	[{"type": "parallelogram", "name": "WIAV"}]
Как называется четырехугольник TYWE, у которого все стороны одинаковой длины и все углы прямые?	[{"type": "quadrilateral", "name": "TYWE"}]
Вычислите сумму внутренних углов равностороннего треугольника LJA со стороной 12 см и равнобедренного треугольника TKY с основанием 10 см и равными сторонами 8 см	[{"type": "triangle", "name": "LJA"}, {"type": "triangle", "name": "TKY"}]
В трапеции OZKC, если AB = CD и AD = BC, как называется трапеция?	[{"type": "trapezoid", "name": "OZKC"}]
Какова площадь квадрата LHUJ, длина стороны которого 65 см?	[{"type": "square", "name": "LHUJ"}]
Найдите величину ∠A в параллелограмме DVYT, если AB = 15 см, BC = 18 см, CD = 15 см и DA = 18 см.	[{"type": "parallelogram", "name": "DVYT"}]
Найдите длину диагонали квадрата UNQB со стороной 18 см.	[{"type": "square", "name": "UNQB"}]
Как называется квадрат OKTS, у которого все стороны одинаковой длины и все углы прямые?	[{"type": "square", "name": "OKTS"}]
Найдите длину диагонали квадрата WULM со стороной 55 см.	[{"type": "square", "name": "WULM"}]
Найдите величину ∠A в квадрате HUJM, если диагонали AC и BD пересекаются под углом 90°.	[{"type": "square", "name": "HUJM"}]
Какова площадь квадрата TCIQ, длина стороны которого 65 см?	[{"type": "square", "name": "TCIQ"}]
Докажите, что диагонали трапеции EJZU не обязательно являются взаимно перпендикулярными биссектрисами.	[{"type": "trapezoid", "name": "EJZU"}]
Найдите периметр квадрата PGZK со стороной 38 см.	[{"type": "square", "name": "PGZK"}]
Найдите сумму внутренних углов равностороннего треугольника YXA со стороной 30 см и прямоугольного треугольника ZVI со сторонами 30 см и 40 см	[{"type": "triangle", "name": "YXA"}, {"type": "triangle", "name": "ZVI"}]
Определите сумму внутренних углов остроугольного треугольника XOM с углами 45°, 60° и 75° и равностороннего треугольника ZYN со стороной 84 см	[{"type": "triangle", "name": "XOM"}, {"type": "triangle", "name": "ZYN"}]
Определите гипотенузу остроугольного треугольника ZWT с углами 45°, 60° и 75° и разностороннего треугольника APS со сторонами 55 см, 57 см и 67 см	[{"type": "triangle", "name": "ZWT"}, {"type": "triangle", "name": "APS"}]
Докажите, что диагонали трапеции WBOL пересекаются под углом 90°.	[{"type": "trapezoid", "name": "WBOL"}]
Найдите периметр трапеции ZHTL, основания которой равны 12 см и 15 см, а высота 10 см.	[{"type": "trapezoid", "name": "ZHTL"}]
Найдите центр описанной окружности треугольника OIS с вершинами в точках (3, 4), (5, -2) и (-2, 6)	[{"type": "triangle", "name": "OIS"}]
Как называется трапеция HYDQ с двумя парами равных сторон?	[{"type": "trapezoid", "name": "HYDQ"}]
Найти уравнение биссектрисы стороны, противоположной вершине C, в треугольнике KQP со сторонами AB = 7, BC = 8, CA = 6	[{"type": "triangle", "name": "KQP"}]
Какова площадь трапеции GVYW, основания которой равны 25 см и 28 см, а высота 20 см?	[{"type": "trapezoid", "name": "GVYW"}]
В параллелограмме OYSR, если ∠A = 90°, найдите величину ∠B.	[{"type": "parallelogram", "name": "OYSR"}]
В четырехугольнике KSHR, если ∠A = 80° и ∠B = 100°, найдите сумму оставшихся двух углов.	[{"type": "quadrilateral", "name": "KSHR"}]
Найдите площадь параллелограмма HKFW, основание которого равно 15 см, а высота — 12 см.	[{"type": "parallelogram", "name": "HKFW"}]
Как называется четырехугольник FOMK, если AB = CD и AD = BC?	[{"type": "quadrilateral", "name": "FOMK"}]
Найдите площадь трапеции AYLH, основания которой равны 18 см и 20 см, а высота 16 см.	[{"type": "trapezoid", "name": "AYLH"}]
Какова площадь трапеции EXKD, основания которой равны 20 см и 22 см, а высота 16 см?	[{"type": "trapezoid", "name": "EXKD"}]
Определите сумму внутренних углов разностороннего треугольника PEK со сторонами 7 см, 9 см и 11 см и прямоугольного треугольника FTX с катетами 8 см и 15 см	[{"type": "triangle", "name": "PEK"}, {"type": "triangle", "name": "FTX"}]
В квадрате VNGT, если ∠A = 90°, найдите меру ∠D.	[{"type": "square", "name": "VNGT"}]
Как называется четырехугольник HCIJ, у которого все стороны имеют одинаковую длину и все внутренние углы имеют одинаковую величину?	[{"type": "quadrilateral", "name": "HCIJ"}]
Найдите высоту остроугольного треугольника EHM с углами 45°, 60° и 75° и тупоугольного треугольника LKQ с углами 120°, 30° и 30°	[{"type": "triangle", "name": "EHM"}, {"type": "triangle", "name": "LKQ"}]
Найдите длину медианы из вершины B в треугольнике TMJ со сторонами длиной 3, 4 и 5 единиц и докажите, что она делит пополам медиану, проведенную из вершины A, тогда и только тогда, когда треугольник является равносторонним	[{"type": "triangle", "name": "TMJ"}]
Вычислите высоту равностороннего треугольника FLW со стороной 20 см и разностороннего треугольника DUP со сторонами 18 см, 22 см и 25 см	[{"type": "triangle", "name": "FLW"}, {"type": "triangle", "name": "DUP"}]
Найдите длину диагонали параллелограмма SWDQ, стороны которого равны 15 см и 18 см.	[{"type": "parallelogram", "name": "SWDQ"}]
Вычислите периметр треугольника KRV, если углы равны 40°, 50° и 90°.	[{"type": "triangle", "name": "KRV"}]
Найдите величину ∠A в четырехугольнике KAEN, если AB = 18 см, BC = 20 см, CD = 18 см и DA = 20 см.	[{"type": "quadrilateral", "name": "KAEN"}]
В квадрате XRGI, если ∠A = 90°, найдите величину ∠B.	[{"type": "square", "name": "XRGI"}]
Найдите длину диагонали квадрата WGAR со стороной 15 см.	[{"type": "square", "name": "WGAR"}]
Определите, лежит ли точка P(x, y) внутри треугольника INB с вершинами в (2, 3), (5, 6) и (8, 1)	[{"type": "triangle", "name": "INB"}]
В четырехугольнике VZFT, если ∠A = 120° и ∠B = 60°, найдите величину ∠C.	[{"type": "quadrilateral", "name": "VZFT"}]
В трапеции CGYM, если AB = CD и AD = BC, как называется трапеция?	[{"type": "trapezoid", "name": "CGYM"}]
Чему равна сумма внутренних углов четырёхугольника PDKX?	[{"type": "quadrilateral", "name": "PDKX"}]
Какова площадь квадрата TYSR, длина стороны которого 35 см?	[{"type": "square", "name": "TYSR"}]
Найдите длину диагонали квадрата VEXP со стороной 12 см.	[{"type": "square", "name": "VEXP"}]
В квадрате GELV, если AB = CD и AD = BC, как называется квадрат?	[{"type": "square", "name": "GELV"}]
В трапеции NMQU, если ∠A = 85° и ∠B = 75°, найдите сумму оставшихся двух углов.	[{"type": "trapezoid", "name": "NMQU"}]
Как называется параллелограмм PLEM, у которого все стороны имеют одинаковую длину и все внутренние углы имеют одинаковую величину?	[{"type": "parallelogram", "name": "PLEM"}]
Какова площадь квадрата BHQF со стороной 18 см?	[{"type": "square", "name": "BHQF"}]
Определите площадь тупоугольного треугольника ZEI со сторонами 25 см, 27 см и 30 см, а также прямоугольного треугольника DBM с катетами 25 см и 35 см	[{"type": "triangle", "name": "ZEI"}, {"type": "triangle", "name": "DBM"}]
Определите, является ли треугольник LXH равносторонним, если углы равны 60°, 60° и 60°.	[{"type": "triangle", "name": "LXH"}]
Как называется четырехугольник IBYT, если AB = CD и AD = BC?	[{"type": "quadrilateral", "name": "IBYT"}]
Найдите периметр четырехугольника VOYQ со сторонами 3 см, 5 см, 7 см и 9 см.	[{"type": "quadrilateral", "name": "VOYQ"}]
Найдите величину ∠C в параллелограмме KCHT, если диагонали AC и BD пересекаются под углом 45°.	[{"type": "parallelogram", "name": "KCHT"}]
Найдите периметр квадрата MSKG со стороной 45 см.	[{"type": "square", "name": "MSKG"}]
Найдите площадь тупоугольного треугольника SJO с углами 100°, 40° и 40°, а также равнобедренного треугольника IRW с основанием 20 см и равными сторонами 18 см	[{"type": "triangle", "name": "SJO"}, {"type": "triangle", "name": "IRW"}]
В квадрате MNKD, если AB = BC = CD = DA, найдите меру ∠A.	[{"type": "square", "name": "MNKD"}]
Как называется четырехугольник THMQ с двумя парами параллельных сторон?	[{"type": "quadrilateral", "name": "THMQ"}]
Вычислите углы треугольника WKG, если два угла дополнительные, а третий угол равен 50°.	[{"type": "triangle", "name": "WKG"}]
Найдите длину диагонали квадрата MAVE со стороной 18 см.	[{"type": "square", "name": "MAVE"}]
Найдите величину ∠B в трапеции ZJBL, если ∠A = 75°.	[{"type": "trapezoid", "name": "ZJBL"}]
Как называется трапеция CSIM, у которой все углы прямые?	[{"type": "trapezoid", "name": "CSIM"}]
В параллелограмме EMAY, если AB = 18 см, BC = 21 см, CD = 18 см и DA = 21 см, найдите величину ∠A.	[{"type": "parallelogram", "name": "EMAY"}]
Найдите величину ∠B в трапеции PFQN, если ∠A = 75°.	[{"type": "trapezoid", "name": "PFQN"}]
Найдите периметр трапеции DJRU, основания которой равны 10 см и 12 см, а высота 8 см.	[{"type": "trapezoid", "name": "DJRU"}]
Вычислите высоту равностороннего треугольника XMS со стороной 40 см и остроугольного треугольника IKE с углами 30°, 60° и 90°	[{"type": "triangle", "name": "XMS"}, {"type": "triangle", "name": "IKE"}]
В параллелограмме LZGK, если ∠A = 90°, найдите величину ∠B.	[{"type": "parallelogram", "name": "LZGK"}]
В квадрате NAQV, если AB = CD и AD = BC, как называется квадрат?	[{"type": "square", "name": "NAQV"}]
Определите, образуют ли точки (2, 3), (5, 6) и (8, 1) остроугольный треугольник KRS	[{"type": "triangle", "name": "KRS"}]
Вычислите длину медианы от вершины А в треугольнике QVG со сторонами длиной 3, 4 и 5 единиц	[{"type": "triangle", "name": "QVG"}]
Как называется четырехугольник QJUX, у которого все стороны имеют одинаковую длину?	[{"type": "quadrilateral", "name": "QJUX"}]
Если стороны треугольника MEU относятся как 1:2:3, найдите длину самой длинной стороны, если периметр равен 54 см.	[{"type": "triangle", "name": "MEU"}]
Найдите площадь трапеции SEIM с вершинами в точках (0, 0), (10, 0), (12, 15) и (0, 15)	[{"type": "trapezoid", "name": "SEIM"}]
Найдите площадь параллелограмма QZIP с вершинами в точках (0, 0), (7, 0), (7, 12) и (0, 12).	[{"type": "parallelogram", "name": "QZIP"}]
Найдите величину ∠A в параллелограмме LBZW, если диагонали AC и BD пересекаются под углом 45°.	[{"type": "parallelogram", "name": "LBZW"}]
Найдите площадь четырехугольника FDUT, основание которого равно 8 см, а высота 5 см.	[{"type": "quadrilateral", "name": "FDUT"}]
Докажите, что диагонали четырехугольника APYJ делят друг друга пополам тогда и только тогда, когда этот четырехугольник является параллелограммом.	[{"type": "quadrilateral", "name": "APYJ"}]
Найдите величину ∠C в трапеции LQGF, если ∠A = 60°.	[{"type": "trapezoid", "name": "LQGF"}]
Найдите величину ∠C в трапеции UWFM, если ∠A = 55°.	[{"type": "trapezoid", "name": "UWFM"}]
Найдите длину стороны равностороннего треугольника ZNB, периметр которого равен 30 см.	[{"type": "triangle", "name": "ZNB"}]
Найдите сумму внутренних углов равнобедренного треугольника WIN с основанием 58 см и равными сторонами 56 см, а также разностороннего треугольника LZY со сторонами 70 см, 72 см и 84 см	[{"type": "triangle", "name": "WIN"}, {"type": "triangle", "name": "LZY"}]
Определите площадь треугольника TEW со сторонами длиной 3, 4 и 5 единиц, используя закон синусов.	[{"type": "triangle", "name": "TEW"}]
Найдите периметр четырехугольника CFNZ со сторонами 7 см, 8 см, 9 см и 10 см.	[{"type": "quadrilateral", "name": "CFNZ"}]
В трапеции QEFW, если ∠A = 85° и ∠B = 75°, найдите сумму оставшихся двух углов.	[{"type": "trapezoid", "name": "QEFW"}]
Найдите площадь трапеции IYOJ, основания которой равны 25 см и 28 см, а высота 20 см.	[{"type": "trapezoid", "name": "IYOJ"}]
Найдите периметр треугольника OGE, если углы равны 55°, 65° и 60°.	[{"type": "triangle", "name": "OGE"}]
Найдите площадь четырехугольника QUTK с вершинами в точках (0, 0), (9, 0), (9, 15) и (0, 15).	[{"type": "quadrilateral", "name": "QUTK"}]
Вычислите периметр прямоугольного треугольника EXF, в котором длина гипотенузы равна 15 см.	[{"type": "triangle", "name": "EXF"}]
Найдите сумму внутренних углов разностороннего треугольника TFQ со сторонами 80 см, 82 см и 98 см, а также равнобедренного треугольника HBJ с основанием 70 см и равными сторонами 68 см	[{"type": "triangle", "name": "TFQ"}, {"type": "triangle", "name": "HBJ"}]
Определите, является ли треугольник LNF равнобедренным, если оба угла при основании равны 20°.	[{"type": "triangle", "name": "LNF"}]
Найдите величину ∠B в четырехугольнике YCBF, если ∠A = 75°.	[{"type": "quadrilateral", "name": "YCBF"}]
Найдите периметр параллелограмма XKMI со сторонами длиной 13 см и 16 см.	[{"type": "parallelogram", "name": "XKMI"}]
Определите, является ли треугольник LAI равнобедренным, если два его угла равны.	[{"type": "triangle", "name": "LAI"}]
Найдите величину ∠C в четырехугольнике TCFN, если ∠A = 110°.	[{"type": "quadrilateral", "name": "TCFN"}]
Найдите площадь параллелограмма VCDX, основание которого равно 8 см, а высота — 6 см.	[{"type": "parallelogram", "name": "VCDX"}]
Найдите длину диагонали параллелограмма JZUP, стороны которого равны 8 см и 10 см.	[{"type": "parallelogram", "name": "JZUP"}]
Определите, является ли треугольник XBP прямоугольным, если гипотенуза равна 15 см, а длина одного катета 9 см.	[{"type": "triangle", "name": "XBP"}]
Найдите периметр четырехугольника CLIY со сторонами 5 см, 6 см, 7 см и 9 см.	[{"type": "quadrilateral", "name": "CLIY"}]
Найдите высоту остроугольного треугольника CZG с углами 45°, 60° и 75°, а также равнобедренного треугольника XYE с основанием 60 см и равными сторонами 58 см	[{"type": "triangle", "name": "CZG"}, {"type": "triangle", "name": "XYE"}]
Докажите, что диагонали параллелограмма UYRZ являются взаимно перпендикулярными и серединными.	[{"type": "parallelogram", "name": "UYRZ"}]
Докажите, что противоположные стороны четырехугольника WLFR не обязательно равны.	[{"type": "quadrilateral", "name": "WLFR"}]
Найдите величину ∠A в четырехугольнике QGFH, если диагонали AC и BD пересекаются под углом 45°.	[{"type": "quadrilateral", "name": "QGFH"}]
Вычислите длину высоты от вершины B в треугольнике XNI со сторонами длиной 5, 6 и 7 единиц и используйте ее для нахождения высоты треугольника	[{"type": "triangle", "name": "XNI"}]
Определите площадь тупоугольного треугольника BGM со сторонами 68 см, 70 см и 82 см, а также прямоугольного треугольника YVJ с катетами 70 см и 90 см	[{"type": "triangle", "name": "BGM"}, {"type": "triangle", "name": "YVJ"}]
Найдите величину ∠C в трапеции BXPO, если ∠A = 60°.	[{"type": "trapezoid", "name": "BXPO"}]
Найдите длину медианы из вершины C в треугольнике YVF со сторонами длиной 7, 8 и 9 единиц и вычислите ее наклон	[{"type": "triangle", "name": "YVF"}]
Найдите площадь трапеции TJPW, основания которой равны 25 см и 28 см, а высота 20 см.	[{"type": "trapezoid", "name": "TJPW"}]
Найдите длину диагонали трапеции GENJ, основания которой равны 16 см и 18 см, а высота 10 см.	[{"type": "trapezoid", "name": "GENJ"}]
Как называется параллелограмм JVPA, у которого все стороны равны и все углы прямые?	[{"type": "parallelogram", "name": "JVPA"}]
Вычислите гипотенузу разностороннего треугольника AFQ со сторонами 20 см, 24 см и 28 см, а также прямоугольного треугольника NMO с катетами 20 см и 30 см	[{"type": "triangle", "name": "AFQ"}, {"type": "triangle", "name": "NMO"}]
Какова площадь параллелограмма DVKO, основание которого равно 14 см, а высота — 12 см?	[{"type": "parallelogram", "name": "DVKO"}]
Найдите площадь квадрата UJVL со стороной 80 см.	[{"type": "square", "name": "UJVL"}]
Какова площадь трапеции JHEA, основания которой равны 22 см и 25 см, а высота 18 см?	[{"type": "trapezoid", "name": "JHEA"}]
Найдите периметр четырехугольника PKHF со сторонами длиной 20 см, 22 см, 24 см и 26 см.	[{"type": "quadrilateral", "name": "PKHF"}]
В трапеции UNRE, если AB = CD и AD = BC, как называется трапеция?	[{"type": "trapezoid", "name": "UNRE"}]
Докажите, что противоположные стороны трапеции KQWV не обязательно параллельны.	[{"type": "trapezoid", "name": "KQWV"}]
Найдите площадь квадрата EZNT со стороной 12 см.	[{"type": "square", "name": "EZNT"}]
Как называется четырёхугольник IQUA, у которого все углы прямые и все стороны разной длины?	[{"type": "quadrilateral", "name": "IQUA"}]
Докажите, что диагонали квадрата NRLH пересекаются и делятся пополам под углом 90°.	[{"type": "square", "name": "NRLH"}]
В квадрате ISHT, если ∠A = 90°, найдите величину ∠B.	[{"type": "square", "name": "ISHT"}]
Найдите площадь треугольника SDJ со сторонами длиной 5, 6 и 7 единиц	[{"type": "triangle", "name": "SDJ"}]
Определите периметр прямоугольного треугольника EIH со сторонами 22 см и 24 см и разностороннего треугольника WFN со сторонами 24 см, 26 см и 30 см	[{"type": "triangle", "name": "EIH"}, {"type": "triangle", "name": "WFN"}]
В параллелограмме ZIPF, если ∠A = 90°, найдите величину ∠B.	[{"type": "parallelogram", "name": "ZIPF"}]
В квадрате XDFA, если AB = BC = CD = DA, найдите меру ∠A.	[{"type": "square", "name": "XDFA"}]
Найдите величину ∠A в трапеции IKDL, если AB = 15 см, BC = 18 см, CD = 15 см и DA = 18 см.	[{"type": "trapezoid", "name": "IKDL"}]
Найдите сумму внутренних углов равнобедренного треугольника WTX с основанием 38 см и равными сторонами 36 см, а также разностороннего треугольника GRP со сторонами 45 см, 47 см и 53 см	[{"type": "triangle", "name": "WTX"}, {"type": "triangle", "name": "GRP"}]
Как называется четырехугольник MJEX с двумя парами параллельных сторон?	[{"type": "quadrilateral", "name": "MJEX"}]
Найдите сумму внутренних углов разностороннего треугольника RSK со сторонами 58 см, 60 см и 68 см, а также равнобедренного треугольника JCZ с основанием 50 см и равными сторонами 48 см	[{"type": "triangle", "name": "RSK"}, {"type": "triangle", "name": "JCZ"}]
Найдите длину медианы из вершины C в треугольнике INY со сторонами длиной 3, 4 и 5 единиц и докажите, что она является высотой треугольника тогда и только тогда, когда это равносторонний треугольник.	[{"type": "triangle", "name": "INY"}]
Вычислите высоту разностороннего треугольника CFP со сторонами 76 см, 78 см и 94 см, а также равнобедренного треугольника GOX с основанием 64 см и равными сторонами 62 см	[{"type": "triangle", "name": "CFP"}, {"type": "triangle", "name": "GOX"}]
В равнобедренном треугольнике UCW, если углы при основании равны 48 градусов, найдите величину угла при вершине.	[{"type": "triangle", "name": "UCW"}]
Как называется квадрат TOBY, у которого все стороны одинаковой длины и все углы прямые?	[{"type": "square", "name": "TOBY"}]
В четырехугольнике WBGR, если ∠A = 80° и ∠B = 100°, найдите сумму оставшихся двух углов.	[{"type": "quadrilateral", "name": "WBGR"}]
Найдите длину медианы из вершины C в треугольнике LAS со сторонами длиной 4, 5 и 7 единиц. Докажите, что эта медиана делит пополам угол между сторонами LM и MN.	[{"type": "triangle", "name": "LAS"}]
Найдите площадь треугольника MGY, если его стороны равны 3 см, 4 см и 5 см.	[{"type": "triangle", "name": "MGY"}]
Определите площадь тупоугольного треугольника MBV со сторонами 68 см, 70 см и 82 см, а также прямоугольного треугольника PYF с катетами 70 см и 90 см	[{"type": "triangle", "name": "MBV"}, {"type": "triangle", "name": "PYF"}]
Докажите, что диагонали трапеции VLOE пересекаются под углом 90°.	[{"type": "trapezoid", "name": "VLOE"}]
В квадрате DFPE, если ∠A = 90°, найдите величину ∠B.	[{"type": "square", "name": "DFPE"}]
В трапеции QMAN, если AB = CD и AD = BC, как называется трапеция?	[{"type": "trapezoid", "name": "QMAN"}]
Как называется параллелограмм HBEQ, у которого все стороны имеют одинаковую длину и все внутренние углы имеют одинаковую величину?	[{"type": "parallelogram", "name": "HBEQ"}]
Определите площадь прямоугольного треугольника VFP с катетами 80 см и 100 см, а также остроугольного треугольника HKN с углами 30°, 60° и 90°	[{"type": "triangle", "name": "VFP"}, {"type": "triangle", "name": "HKN"}]
Найдите периметр равнобедренного треугольника XJG с основанием 34 см и равными сторонами 32 см, а также тупоугольного треугольника DVM со сторонами 38 см, 40 см и 46 см	[{"type": "triangle", "name": "XJG"}, {"type": "triangle", "name": "DVM"}]
Найдите периметр параллелограмма ZJPD со сторонами 11 см и 13 см.	[{"type": "parallelogram", "name": "ZJPD"}]
Докажите, что сумма внутренних углов четырехугольника RMSX равна 360°.	[{"type": "quadrilateral", "name": "RMSX"}]
Вычислите высоту равностороннего треугольника CFS со стороной 40 см и остроугольного треугольника MHJ с углами 30°, 60° и 90°	[{"type": "triangle", "name": "CFS"}, {"type": "triangle", "name": "MHJ"}]
Найдите длину диагонали параллелограмма YJDG, стороны которого равны 19 см и 23 см.	[{"type": "parallelogram", "name": "YJDG"}]
Докажите, что сумма внутренних углов четырехугольника MBCD всегда равна сумме внутренних углов двух треугольников.	[{"type": "quadrilateral", "name": "MBCD"}]
Определите гипотенузу прямоугольного треугольника XFZ с катетами 5 см и 12 см и разностороннего треугольника SAD со сторонами 6 см, 8 см и 10 см	[{"type": "triangle", "name": "XFZ"}, {"type": "triangle", "name": "SAD"}]
Определите, является ли треугольник RGF треугольником 30-60-90, если его стороны имеют длину 5, 12 и 13 единиц	[{"type": "triangle", "name": "RGF"}]
Определите, является ли треугольник CBP остроугольным, если его стороны имеют длины 5, 6 и 7 единиц	[{"type": "triangle", "name": "CBP"}]
Найдите длину медианы трапеции FWBJ, основания которой равны 20 см и 22 см, а высота — 14 см.	[{"type": "trapezoid", "name": "FWBJ"}]
Найдите величину ∠C в четырехугольнике PEBQ, если ∠A = 55°.	[{"type": "quadrilateral", "name": "PEBQ"}]
Найдите длину высоты от вершины B в треугольнике SXF со сторонами длиной 7, 8 и 9 единиц	[{"type": "triangle", "name": "SXF"}]
Найдите величину ∠C в четырехугольнике SEOW, если ∠A = 110°.	[{"type": "quadrilateral", "name": "SEOW"}]
В параллелограмме SKLA, если ∠A = 30°, найдите величину ∠B.	[{"type": "parallelogram", "name": "SKLA"}]
Докажите, что диагонали квадрата NEFJ пересекаются и делятся пополам под углом 90°.	[{"type": "square", "name": "NEFJ"}]
Найдите величину ∠A в трапеции KTSX, если диагонали AC и BD пересекаются под углом 45°.	[{"type": "trapezoid", "name": "KTSX"}]
Найдите сумму внутренних углов равностороннего треугольника JTB со стороной 72 см и прямоугольного треугольника UCQ со сторонами 74 см и 90 см	[{"type": "triangle", "name": "JTB"}, {"type": "triangle", "name": "UCQ"}]
Найдите центр тяжести треугольника MED с вершинами в (1, 2), (3, 4) и (5, 6)	[{"type": "triangle", "name": "MED"}]
Найдите высоту равнобедренного треугольника YZR с основанием 8 см и равными сторонами по 6 см, а также равностороннего треугольника HUW со стороной 7 см	[{"type": "triangle", "name": "YZR"}, {"type": "triangle", "name": "HUW"}]
Докажите, что длины противоположных сторон параллелограмма SEJV равны.	[{"type": "parallelogram", "name": "SEJV"}]
Докажите, что противоположные стороны трапеции QSWI не обязательно параллельны.	[{"type": "trapezoid", "name": "QSWI"}]
В параллелограмме AZSO, если AB = CD, как называется параллелограмм?	[{"type": "parallelogram", "name": "AZSO"}]
Найдите периметр параллелограмма UJRO, стороны которого равны 9 см и 11 см.	[{"type": "parallelogram", "name": "UJRO"}]
Найдите площадь квадрата EVUC со стороной 12 см.	[{"type": "square", "name": "EVUC"}]
Найдите площадь тупоугольного треугольника DQY с углами 110°, 40° и 30°, а также равнобедренного треугольника RXF с основанием 36 см и равными сторонами 34 см	[{"type": "triangle", "name": "DQY"}, {"type": "triangle", "name": "RXF"}]
Вычислите углы треугольника ZML, если два угла равны и каждый равен 45°.	[{"type": "triangle", "name": "ZML"}]
Докажите, что сумма внутренних углов четырехугольника CVEF равна 360°.	[{"type": "quadrilateral", "name": "CVEF"}]
Докажите, что диагонали квадрата JXDB являются взаимно перпендикулярными биссектрисами.	[{"type": "square", "name": "JXDB"}]
Найдите периметр параллелограмма BPYO, стороны которого равны 14 см и 17 см.	[{"type": "parallelogram", "name": "BPYO"}]
Найдите высоту остроугольного треугольника VUX с углами 45°, 60° и 75°, а также равнобедренного треугольника TAY с основанием 60 см и равными сторонами 58 см	[{"type": "triangle", "name": "VUX"}, {"type": "triangle", "name": "TAY"}]
Найдите периметр квадрата LMSK со стороной 45 см.	[{"type": "square", "name": "LMSK"}]
Найдите величину ∠A в параллелограмме WVDC, если диагонали AC и BD пересекаются под углом 60°.	[{"type": "parallelogram", "name": "WVDC"}]
Найдите периметр квадрата EPIF со стороной 18 см.	[{"type": "square", "name": "EPIF"}]
Найдите величину ∠B в трапеции JDML, если ∠A = 70°.	[{"type": "trapezoid", "name": "JDML"}]
Какова площадь параллелограмма BXZI, основание которого равно 14 см, а высота — 12 см?	[{"type": "parallelogram", "name": "BXZI"}]
Определите периметр тупоугольного треугольника TCJ со сторонами 98 см, 100 см и 126 см и остроугольного треугольника LGR с углами 30°, 60° и 90°	[{"type": "triangle", "name": "TCJ"}, {"type": "triangle", "name": "LGR"}]
Докажите, что диагонали квадрата KCWS пересекаются и делятся пополам под углом 90°.	[{"type": "square", "name": "KCWS"}]
Найдите длину диагонали четырехугольника WDNJ, стороны которого равны 10 см, 12 см и 14 см.	[{"type": "quadrilateral", "name": "WDNJ"}]
Если периметр треугольника TXW равен 24 см, а стороны относятся как 2:3:4, найдите длину самой длинной стороны.	[{"type": "triangle", "name": "TXW"}]
Найдите площадь прямоугольного треугольника BHX с катетами 52 см и 64 см, а также равностороннего треугольника QAN со стороной 50 см	[{"type": "triangle", "name": "BHX"}, {"type": "triangle", "name": "QAN"}]
Найдите площадь параллелограмма JAER с вершинами в точках (0, 0), (4, 0), (4, 6) и (0, 6).	[{"type": "parallelogram", "name": "JAER"}]
Найдите площадь параллелограмма JEAG, основание которого равно 20 см, а высота — 18 см.	[{"type": "parallelogram", "name": "JEAG"}]
Найдите величину ∠A в квадрате XPLA, если диагонали AC и BD пересекаются под углом 90°.	[{"type": "square", "name": "XPLA"}]
Вычислите гипотенузу разностороннего треугольника MJO со сторонами 20 см, 24 см и 28 см, а также прямоугольного треугольника CAD с катетами 20 см и 30 см	[{"type": "triangle", "name": "MJO"}, {"type": "triangle", "name": "CAD"}]
В треугольнике LGA, если высота от вершины P до стороны QR равна 10 см, а площадь 40 см², найдите длину QR.	[{"type": "triangle", "name": "LGA"}]
Докажите, что противолежащие углы параллелограмма FTCV являются дополнительными.	[{"type": "parallelogram", "name": "FTCV"}]
Определите гипотенузу разностороннего треугольника ENB со сторонами 10 см, 12 см и 16 см и прямоугольного треугольника ALZ с катетами 10 см и 24 см	[{"type": "triangle", "name": "ENB"}, {"type": "triangle", "name": "ALZ"}]
Определите периметр прямоугольного треугольника TOU со сторонами 66 см и 76 см и разностороннего треугольника MLQ со сторонами 68 см, 70 см и 82 см	[{"type": "triangle", "name": "TOU"}, {"type": "triangle", "name": "MLQ"}]
Как называется параллелограмм DOFX, если AB = CD и AD = BC?	[{"type": "parallelogram", "name": "DOFX"}]
Найдите длину медианы из вершины B в треугольнике AVZ со сторонами длиной 3, 4 и 5 единиц. Докажите, что эта медиана делит пополам угол между сторонами SU и ST.	[{"type": "triangle", "name": "AVZ"}]
Определите периметр прямоугольного треугольника ZOB со сторонами 42 см и 48 см и разностороннего треугольника AQY со сторонами 44 см, 46 см и 52 см	[{"type": "triangle", "name": "ZOB"}, {"type": "triangle", "name": "AQY"}]
Найдите площадь четырехугольника AUTE, основание которого равно 10 см, а высота — 8 см.	[{"type": "quadrilateral", "name": "AUTE"}]
Определите гипотенузу остроугольного треугольника VZJ с углами 45°, 60° и 75° и разностороннего треугольника OTY со сторонами 102 см, 104 см и 134 см	[{"type": "triangle", "name": "VZJ"}, {"type": "triangle", "name": "OTY"}]
Найдите длину медианы из вершины A в треугольнике QDP со сторонами длиной 5, 6 и 7 единиц и докажите, что она делит пополам угол между сторонами DE и DF тогда и только тогда, когда треугольник равнобедренный	[{"type": "triangle", "name": "QDP"}]
В квадрате VQCX, если ∠A = 90°, найдите величину ∠B.	[{"type": "square", "name": "VQCX"}]
Найдите длину медианы трапеции EOBQ, основания которой равны 18 см и 20 см, а высота — 12 см.	[{"type": "trapezoid", "name": "EOBQ"}]
В квадрате OAGK, если ∠A = 90°, найдите величины оставшихся трех углов.	[{"type": "square", "name": "OAGK"}]
Найдите длину стороны равностороннего треугольника IJS, периметр которого равен 54 см.	[{"type": "triangle", "name": "IJS"}]
Найдите площадь треугольника NCW, если его полупериметр равен 8 см.	[{"type": "triangle", "name": "NCW"}]
Как называется четырехугольник PYRD, если диагонали AC и BD пересекаются под углом 90°?	[{"type": "quadrilateral", "name": "PYRD"}]
Вычислите площадь равнобедренного треугольника GQF с основанием 62 см и равными сторонами 60 см, а также разностороннего треугольника VPC со сторонами 74 см, 76 см и 90 см	[{"type": "triangle", "name": "GQF"}, {"type": "triangle", "name": "VPC"}]
Найдите площадь тупоугольного треугольника NPZ с углами 120°, 40° и 20°, а также равнобедренного треугольника RXO с основанием 78 см и равными сторонами 76 см	[{"type": "triangle", "name": "NPZ"}, {"type": "triangle", "name": "RXO"}]
Как называется параллелограмм OTZY, если AB = CD и AD = BC?	[{"type": "parallelogram", "name": "OTZY"}]
Найдите периметр трапеции HQKZ, основания которой равны 20 см и 25 см, а высота — 16 см.	[{"type": "trapezoid", "name": "HQKZ"}]
Найдите сумму внутренних углов равностороннего треугольника XWD со стороной 96 см и прямоугольного треугольника MEC со сторонами 98 см и 128 см	[{"type": "triangle", "name": "XWD"}, {"type": "triangle", "name": "MEC"}]
Вычислите периметр разностороннего треугольника PIL со сторонами 72 см, 74 см и 86 см, а также равностороннего треугольника GKV со стороной 70 см	[{"type": "triangle", "name": "PIL"}, {"type": "triangle", "name": "GKV"}]
Найдите величину ∠A в параллелограмме CLBI, если AB = 10 см, BC = 12 см, CD = 10 см и DA = 12 см.	[{"type": "parallelogram", "name": "CLBI"}]
В четырёхугольнике RLMB, если ∠A + ∠C = 180°, как называется четырёхугольник?	[{"type": "quadrilateral", "name": "RLMB"}]
Найдите длину стороны равнобедренного треугольника CPA, периметр которого равен 36 см.	[{"type": "triangle", "name": "CPA"}]
Найдите площадь параллелограмма MJBE, основание которого равно 8 см, а высота — 6 см.	[{"type": "parallelogram", "name": "MJBE"}]
Определите сумму внутренних углов остроугольного треугольника EQS с углами 45°, 60° и 75°, а также равностороннего треугольника IBP со стороной 62 см	[{"type": "triangle", "name": "EQS"}, {"type": "triangle", "name": "IBP"}]
Найдите длину стороны правильного треугольника WYQ, периметр которого равен 36 см.	[{"type": "triangle", "name": "WYQ"}]
Найдите периметр четырехугольника ESIJ со сторонами 5 см, 6 см, 7 см и 8 см.	[{"type": "quadrilateral", "name": "ESIJ"}]
Найдите величину ∠C в трапеции DFIU, если ∠A = 65°.	[{"type": "trapezoid", "name": "DFIU"}]
Как называется квадрат HYEC, у которого все углы прямые?	[{"type": "square", "name": "HYEC"}]
Найдите периметр четырехугольника RWUD со сторонами длиной 16 см, 18 см, 20 см и 22 см.	[{"type": "quadrilateral", "name": "RWUD"}]
В квадрате DRUJ, если AB = CD и AD = BC, как называется квадрат?	[{"type": "square", "name": "DRUJ"}]
Каков периметр трапеции FGET, основания которой имеют длины 20 см и 25 см, а высота 18 см?	[{"type": "trapezoid", "name": "FGET"}]
Вычислите высоту равностороннего треугольника FNY со стороной 24 см и остроугольного треугольника HTB с углами 30°, 60° и 90°	[{"type": "triangle", "name": "FNY"}, {"type": "triangle", "name": "HTB"}]
Определите гипотенузу разностороннего треугольника UEA со сторонами 10 см, 12 см и 16 см и прямоугольного треугольника GTH с катетами 10 см и 24 см	[{"type": "triangle", "name": "UEA"}, {"type": "triangle", "name": "GTH"}]
Определите площадь прямоугольного треугольника EFR с катетами 15 см и 20 см, а также остроугольного треугольника MYS с углами 30°, 60° и 90°	[{"type": "triangle", "name": "EFR"}, {"type": "triangle", "name": "MYS"}]
Найдите площадь параллелограмма ONUC, основание которого равно 18 см, а высота — 15 см.	[{"type": "parallelogram", "name": "ONUC"}]
В четырехугольнике GUVX, если ∠A = 90° и ∠B = 45°, найдите величину ∠C.	[{"type": "quadrilateral", "name": "GUVX"}]
Найдите площадь квадрата QXOE с вершинами в точках (0, 0), (40, 0), (40, 40) и (0, 40).	[{"type": "square", "name": "QXOE"}]
Найдите координаты ортоцентра треугольника JFU с вершинами (1, 2), (3, 4) и (5, 6)	[{"type": "triangle", "name": "JFU"}]
Как называется четырёхугольник XJYR, у которого все углы прямые и все стороны разной длины?	[{"type": "quadrilateral", "name": "XJYR"}]
Вычислите площадь равнобедренного треугольника RFL с основанием 62 см и равными сторонами 60 см, а также разностороннего треугольника ZPK со сторонами 74 см, 76 см и 90 см	[{"type": "triangle", "name": "RFL"}, {"type": "triangle", "name": "ZPK"}]
В квадрате DNMH, если AB = BC = CD = DA, найдите меру ∠C.	[{"type": "square", "name": "DNMH"}]
Вычислите площадь равнобедренного треугольника XRC с основанием 28 см и равными сторонами 26 см, а также разностороннего треугольника WJZ со сторонами 30 см, 32 см и 36 см	[{"type": "triangle", "name": "XRC"}, {"type": "triangle", "name": "WJZ"}]
Докажите, что диагонали квадрата FEJG пересекаются и делятся пополам под углом 90°.	[{"type": "square", "name": "FEJG"}]
Найдите площадь квадрата ODFM со стороной 80 см.	[{"type": "square", "name": "ODFM"}]
Какова площадь четырехугольника LDRH, основание которого равно 16 см, а высота — 14 см?	[{"type": "quadrilateral", "name": "LDRH"}]
Вычислите длину гипотенузы прямоугольного треугольника PXT с катетами длиной 5 и 12 единиц	[{"type": "triangle", "name": "PXT"}]
Вычислите высоту разностороннего треугольника UXG со сторонами 76 см, 78 см и 94 см, а также равнобедренного треугольника APE с основанием 64 см и равными сторонами 62 см	[{"type": "triangle", "name": "UXG"}, {"type": "triangle", "name": "APE"}]
Найдите площадь трапеции FCHI, основания которой равны 25 см и 28 см, а высота 20 см.	[{"type": "trapezoid", "name": "FCHI"}]
Вычислите периметр разностороннего треугольника IEZ со сторонами 48 см, 50 см и 56 см, а также равностороннего треугольника RYH со стороной 44 см	[{"type": "triangle", "name": "IEZ"}, {"type": "triangle", "name": "RYH"}]
Найдите длину медианы трапеции JUYR, основания которой равны 18 см и 20 см, а высота — 12 см.	[{"type": "trapezoid", "name": "JUYR"}]
Вычислить расстояние от точки P(2, 3) до середины M стороны BC в треугольнике VQG с вершинами в (1, 2), (3, 4) и (5, 6)	[{"type": "triangle", "name": "VQG"}]
Докажите, что противоположные стороны трапеции KJOV не обязательно параллельны.	[{"type": "trapezoid", "name": "KJOV"}]
Найдите периметр трапеции WOQX, основания которой равны 20 см и 22 см, а высота — 14 см.	[{"type": "trapezoid", "name": "WOQX"}]
Как называется трапеция AQGT с двумя парами равных сторон?	[{"type": "trapezoid", "name": "AQGT"}]
Если стороны треугольника TOB относятся как 3:4:5, найдите длину самой длинной стороны, если периметр равен 72 см.	[{"type": "triangle", "name": "TOB"}]
Какова сумма внутренних углов параллелограмма INUS, один из углов которого равен 60°?	[{"type": "parallelogram", "name": "INUS"}]
Определите периметр прямоугольного треугольника WPF со сторонами 42 см и 48 см и разностороннего треугольника EMR со сторонами 44 см, 46 см и 52 см	[{"type": "triangle", "name": "WPF"}, {"type": "triangle", "name": "EMR"}]
Определите, конгруэнтен ли треугольник JAD треугольнику DEF со сторонами длиной 5, 6 и 7 единиц и сторонами длиной 3, 4 и 5 единиц соответственно	[{"type": "triangle", "name": "JAD"}]
Найдите величину ∠D в параллелограмме FWSL, если ∠A = 120°.	[{"type": "parallelogram", "name": "FWSL"}]
Найдите длину медианы из вершины А в треугольнике IOP со сторонами длиной 3, 4 и 5 единиц. Докажите, что эта медиана делит треугольник на две равные площади.	[{"type": "triangle", "name": "IOP"}]
Докажите, что сумма внутренних углов четырехугольника QWYP равна 360°.	[{"type": "quadrilateral", "name": "QWYP"}]
Найдите величину ∠C в трапеции LDTX, если ∠A = 100°.	[{"type": "trapezoid", "name": "LDTX"}]
В трапеции VQJM, если ∠A = 85° и ∠B = 75°, найдите сумму оставшихся двух углов.	[{"type": "trapezoid", "name": "VQJM"}]
Найдите площадь квадрата CWMF со стороной 20 см.	[{"type": "square", "name": "CWMF"}]
Вычислите высоту разностороннего треугольника QJI со сторонами 52 см, 54 см и 64 см, а также равнобедренного треугольника RMZ с основанием 44 см и равными сторонами 42 см	[{"type": "triangle", "name": "QJI"}, {"type": "triangle", "name": "RMZ"}]
Докажите, что диагонали трапеции YLCK не обязательно являются взаимно перпендикулярными биссектрисами.	[{"type": "trapezoid", "name": "YLCK"}]
В квадрате GXOH, если AB = BC = CD = DA, найдите меру ∠C.	[{"type": "square", "name": "GXOH"}]
Найдите сумму внутренних углов разностороннего треугольника FLC со сторонами 80 см, 82 см и 98 см, а также равнобедренного треугольника INO с основанием 70 см и равными сторонами 68 см	[{"type": "triangle", "name": "FLC"}, {"type": "triangle", "name": "INO"}]
Найдите периметр квадрата NGSO со стороной 20 см.	[{"type": "square", "name": "NGSO"}]
В четырехугольнике WDIK, если AB = 8 см, BC = 10 см, CD = 12 см, DA = 14 см и ∠A = 90°, найдите меру ∠C.	[{"type": "quadrilateral", "name": "WDIK"}]
Найдите площадь прямоугольного треугольника WSV с катетами 76 см и 94 см, а также равностороннего треугольника DFR со стороной 74 см	[{"type": "triangle", "name": "WSV"}, {"type": "triangle", "name": "DFR"}]
Найдите величину ∠A в трапеции OQFE, если диагонали AC и BD пересекаются под углом 60°.	[{"type": "trapezoid", "name": "OQFE"}]
В равнобедренном треугольнике IDW, если углы при основании равны 70 градусов, какова величина угла при вершине?	[{"type": "triangle", "name": "IDW"}]
Найдите длину высоты из вершины B в треугольнике MXF со сторонами длиной 10, 11 и 12 единиц	[{"type": "triangle", "name": "MXF"}]
Как называется параллелограмм MQHK, если AB = CD и AD = BC?	[{"type": "parallelogram", "name": "MQHK"}]
Найдите величину ∠A в трапеции GDJT, если диагонали AC и BD пересекаются под углом 60°.	[{"type": "trapezoid", "name": "GDJT"}]
Докажите, что сумма внутренних углов четырехугольника YTAO всегда равна 360°.	[{"type": "quadrilateral", "name": "YTAO"}]
Какова сумма внутренних углов параллелограмма WKBJ, один из углов которого равен 60°?	[{"type": "parallelogram", "name": "WKBJ"}]
Найдите площадь трапеции UBQJ, основания которой равны 22 см и 25 см, а высота 18 см.	[{"type": "trapezoid", "name": "UBQJ"}]
Как называется четырехугольник PIKM, у которого все внутренние углы равны?	[{"type": "quadrilateral", "name": "PIKM"}]
Найдите периметр параллелограмма IMXV со сторонами длиной 13 см и 16 см.	[{"type": "parallelogram", "name": "IMXV"}]
Определите сумму внутренних углов остроугольного треугольника DJA с углами 45°, 60° и 75° и равностороннего треугольника OSI со стороной 38 см	[{"type": "triangle", "name": "DJA"}, {"type": "triangle", "name": "OSI"}]
Определите, является ли треугольник JGK равнобедренным, если угол при основании равен 30°.	[{"type": "triangle", "name": "JGK"}]
Определите длину стороны треугольника QCR, который представляет собой равнобедренный треугольник с периметром 30 см.	[{"type": "triangle", "name": "QCR"}]
Вычислите гипотенузу разностороннего треугольника IZO со сторонами 86 см, 88 см и 106 см, а также прямоугольного треугольника DYL с катетами 86 см и 110 см	[{"type": "triangle", "name": "IZO"}, {"type": "triangle", "name": "DYL"}]
Найдите величину ∠A в трапеции LBHO, если диагонали AC и BD пересекаются под углом 60°.	[{"type": "trapezoid", "name": "LBHO"}]
Докажите, что противоположные стороны трапеции JOKN не обязательно параллельны.	[{"type": "trapezoid", "name": "JOKN"}]
Как называется параллелограмм AHTZ, если AB = CD и AD = BC?	[{"type": "parallelogram", "name": "AHTZ"}]
В квадрате RZEJ, если AB = BC = CD = DA, найдите меру ∠C.	[{"type": "square", "name": "RZEJ"}]
Вычислите периметр треугольника SBN, если углы равны 45°, 50° и 85°.	[{"type": "triangle", "name": "SBN"}]
Найдите периметр четырехугольника CIZY со сторонами длиной 10 см, 12 см, 14 см и 16 см.	[{"type": "quadrilateral", "name": "CIZY"}]
Найдите площадь четырехугольника FMUP с вершинами (0, 0), (4, 0), (4, 3) и (0, 3).	[{"type": "quadrilateral", "name": "FMUP"}]
Определите, является ли треугольник LGM равнобедренным, если его стороны имеют длины 5, 5 и 12 единиц.	[{"type": "triangle", "name": "LGM"}]
Определите гипотенузу остроугольного треугольника FPU с углами 45°, 60° и 75° и разностороннего треугольника SIZ со сторонами 34 см, 36 см и 42 см	[{"type": "triangle", "name": "FPU"}, {"type": "triangle", "name": "SIZ"}]
Как называется четырехугольник KLJX с двумя парами параллельных сторон?	[{"type": "quadrilateral", "name": "KLJX"}]
Найдите величину ∠D в параллелограмме MPON, если ∠A = 60°.	[{"type": "parallelogram", "name": "MPON"}]
Найдите площадь квадрата WLXA со стороной 42 см.	[{"type": "square", "name": "WLXA"}]
Как называется трапеция HSNM с двумя парами равных сторон?	[{"type": "trapezoid", "name": "HSNM"}]
Определите площадь треугольника NRK со сторонами длиной 5, 6 и 7 единиц, используя закон косинусов	[{"type": "triangle", "name": "NRK"}]
Как называется четырехугольник GDIE, если AB = CD и AD = BC?	[{"type": "quadrilateral", "name": "GDIE"}]
Найдите величину ∠C в трапеции MXBF, если ∠A = 55°.	[{"type": "trapezoid", "name": "MXBF"}]
В квадрате BICE, если ∠A = 90°, найдите меру ∠D.	[{"type": "square", "name": "BICE"}]
Найдите площадь параллелограмма PLBJ, основание которого равно 15 см, а высота — 12 см.	[{"type": "parallelogram", "name": "PLBJ"}]
Как называется трапеция VCSZ, у которой все стороны имеют одинаковую длину?	[{"type": "trapezoid", "name": "VCSZ"}]
Найдите длину диагонали четырехугольника ZDEK, стороны которого равны 12 см, 14 см и 16 см.	[{"type": "quadrilateral", "name": "ZDEK"}]
Найдите длину медианы из вершины B в треугольнике WTB со сторонами длиной 5, 6 и 7 единиц и докажите, что она делит пополам медиану, проведенную из вершины C, тогда и только тогда, когда треугольник равносторонний	[{"type": "triangle", "name": "WTB"}]
Найдите площадь трапеции RMYZ, основания которой равны 18 см и 22 см, а высота 14 см.	[{"type": "trapezoid", "name": "RMYZ"}]
Вычислите периметр треугольника VAP, если углы равны 55°, 65° и 60°.	[{"type": "triangle", "name": "VAP"}]
В четырехугольнике HJRD, если AB = CD и AD = BC, найти меру ∠A.	[{"type": "quadrilateral", "name": "HJRD"}]
Докажите, что диагонали четырехугольника IFTB не обязательно являются взаимно перпендикулярными биссектрисами.	[{"type": "quadrilateral", "name": "IFTB"}]
В треугольнике AKS длины сторон равны x+2, 2x-1 и 3x+4. Найдите значение х.	[{"type": "triangle", "name": "AKS"}]
Найдите периметр параллелограмма DOHS, стороны которого равны 18 см и 24 см.	[{"type": "parallelogram", "name": "DOHS"}]
Найдите площадь параллелограмма VQCO, основание которого равно 9 см, а высота — 7 см.	[{"type": "parallelogram", "name": "VQCO"}]
Найдите величину ∠A в трапеции UFSO, если AB = 22 см, BC = 25 см, CD = 22 см и DA = 25 см.	[{"type": "trapezoid", "name": "UFSO"}]
Вычислите гипотенузу разностороннего треугольника TVY со сторонами 40 см, 42 см и 48 см, а также прямоугольного треугольника RXJ с катетами 40 см и 50 см	[{"type": "triangle", "name": "TVY"}, {"type": "triangle", "name": "RXJ"}]
Докажите, что сумма внутренних углов четырехугольника YDHG всегда равна сумме внутренних углов двух треугольников.	[{"type": "quadrilateral", "name": "YDHG"}]
Найдите сумму внутренних углов разностороннего треугольника AHU со сторонами 35 см, 37 см и 40 см, а также равнобедренного треугольника GNQ с основанием 30 см и равными сторонами 28 см	[{"type": "triangle", "name": "AHU"}, {"type": "triangle", "name": "GNQ"}]
Найдите длину медианы трапеции WUMH, основания которой равны 16 см и 18 см, а высота — 12 см.	[{"type": "trapezoid", "name": "WUMH"}]
В треугольнике XRN, если углы относятся как 5:7:8, найдите величину наибольшего угла.	[{"type": "triangle", "name": "XRN"}]
Если стороны треугольника ILV относятся как 2:3:4, найдите длину самой длинной стороны, если периметр равен 30 см.	[{"type": "triangle", "name": "ILV"}]
В четырехугольнике BYFP, если ∠A = 85° и ∠B = 75°, найдите сумму оставшихся двух углов.	[{"type": "quadrilateral", "name": "BYFP"}]
Найдите длину диагонали квадрата QNIG со стороной 75 см.	[{"type": "square", "name": "QNIG"}]
В квадрате RJWA, если AB = BC = CD = DA, найдите меру ∠C.	[{"type": "square", "name": "RJWA"}]
Найдите периметр равнобедренного треугольника CFW с основанием 76 см и равными сторонами 74 см, а также тупоугольного треугольника SLE со сторонами 84 см, 86 см и 104 см	[{"type": "triangle", "name": "CFW"}, {"type": "triangle", "name": "SLE"}]
Определите, лежит ли точка (4, 5) внутри или снаружи треугольника JQM с вершинами в (1, 2), (3, 4) и (5, 6)	[{"type": "triangle", "name": "JQM"}]
В треугольнике CAO, если углы относятся как 2:3:4, найдите величину наименьшего угла.	[{"type": "triangle", "name": "CAO"}]
Найдите площадь трапеции YJTH, основания которой равны 18 см и 22 см, а высота 14 см.	[{"type": "trapezoid", "name": "YJTH"}]
Найдите площадь четырехугольника IQML, основание которого равно 15 см, а высота — 12 см.	[{"type": "quadrilateral", "name": "IQML"}]
Определите, является ли треугольник TWA прямоугольным, если длина гипотенузы 13 см, а длина одного катета 5 см.	[{"type": "triangle", "name": "TWA"}]
Найдите площадь квадрата HTZV с вершинами в точках (0, 0), (30, 0), (30, 30) и (0, 30).	[{"type": "square", "name": "HTZV"}]
Какова площадь параллелограмма TYLJ, основание которого равно 10 см, а высота — 8 см?	[{"type": "parallelogram", "name": "TYLJ"}]
В квадрате SHXP, если AB = CD и AD = BC, как называется квадрат?	[{"type": "square", "name": "SHXP"}]
Найдите величину ∠A в трапеции LHWV, если AB = 20 см, BC = 22 см, CD = 20 см и DA = 22 см.	[{"type": "trapezoid", "name": "LHWV"}]
Найдите величину ∠A в квадрате EOYR, если диагонали AC и BD пересекаются под углом 90°.	[{"type": "square", "name": "EOYR"}]
Найдите площадь четырехугольника GEXV, основание которого равно 12 см, высота — 9 см, а один из углов равен 45°.	[{"type": "quadrilateral", "name": "GEXV"}]
В трапеции KVRX, если AB = CD и AD = BC, как называется трапеция?	[{"type": "trapezoid", "name": "KVRX"}]
Найдите площадь параллелограмма FHUV, основание которого равно 11 см, а высота — 10 см.	[{"type": "parallelogram", "name": "FHUV"}]
Какова сумма внутренних углов параллелограмма IXGS?	[{"type": "parallelogram", "name": "IXGS"}]
Найдите длину диагонали квадрата RIWL со стороной 75 см.	[{"type": "square", "name": "RIWL"}]
Докажите, что диагонали трапеции MJKP не обязательно являются взаимно перпендикулярными биссектрисами.	[{"type": "trapezoid", "name": "MJKP"}]
Докажите, что диагонали параллелограмма JDTE равны.	[{"type": "parallelogram", "name": "JDTE"}]
Найдите периметр трапеции QYNO, основания которой равны 20 см и 25 см, а высота — 16 см.	[{"type": "trapezoid", "name": "QYNO"}]
Как называется четырехугольник OBJG с двумя парами равных сторон?	[{"type": "quadrilateral", "name": "OBJG"}]
В треугольнике FKN, если высота от вершины P до стороны QR равна 8 см, а площадь 24 см², найдите длину QR.	[{"type": "triangle", "name": "FKN"}]
В квадрате ERWG, если ∠A = 90°, найдите величину ∠B.	[{"type": "square", "name": "ERWG"}]
Найдите площадь прямоугольного треугольника LEH с катетами 76 см и 94 см, а также равностороннего треугольника SXU со стороной 74 см	[{"type": "triangle", "name": "LEH"}, {"type": "triangle", "name": "SXU"}]
Найдите длину диагонали четырехугольника DFXU, стороны которого равны 14 см, 16 см и 18 см.	[{"type": "quadrilateral", "name": "DFXU"}]
Как называется четырехугольник VDYU, если диагонали AC и BD пересекаются под углом 90°?	[{"type": "quadrilateral", "name": "VDYU"}]
Какова площадь четырехугольника FPJD, основание которого равно 18 см, а высота — 16 см?	[{"type": "quadrilateral", "name": "FPJD"}]
Вычислите длину медианы от вершины L в треугольнике YVU со сторонами длиной 4, 5 и 7 единиц	[{"type": "triangle", "name": "YVU"}]
Найдите площадь четырехугольника BQEO с вершинами в точках (1, 1), (4, 1), (4, 5) и (1, 5).	[{"type": "quadrilateral", "name": "BQEO"}]
Найдите длину диагонали четырехугольника BELP, стороны которого равны 14 см, 16 см и 18 см.	[{"type": "quadrilateral", "name": "BELP"}]
Найдите периметр параллелограмма TNQP, стороны которого равны 15 см и 19 см.	[{"type": "parallelogram", "name": "TNQP"}]
Как называется четырехугольник VDOE, у которого все углы прямые и все стороны разной длины?	[{"type": "quadrilateral", "name": "VDOE"}]
Найдите периметр треугольника ECG, если его стороны равны х см, х+3 см и 2х-1 см.	[{"type": "triangle", "name": "ECG"}]
Как называется параллелограмм TKZS, если AB = CD и AD = BC?	[{"type": "parallelogram", "name": "TKZS"}]
Найдите сумму внутренних углов разностороннего треугольника GET со сторонами 15 см, 18 см и 20 см, а также равнобедренного треугольника UYB с основанием 12 см и равными сторонами 10 см	[{"type": "triangle", "name": "GET"}, {"type": "triangle", "name": "UYB"}]
Найдите величину ∠D в параллелограмме KOJR, если ∠A = 110°.	[{"type": "parallelogram", "name": "KOJR"}]
Найдите периметр трапеции FWDI, основания которой равны 28 см и 30 см, а высота — 22 см.	[{"type": "trapezoid", "name": "FWDI"}]
Найдите площадь трапеции YEOI, основания которой равны 25 см и 28 см, а высота 20 см.	[{"type": "trapezoid", "name": "YEOI"}]
Вычислите высоту разностороннего треугольника WOG со сторонами 52 см, 54 см и 64 см, а также равнобедренного треугольника VTM с основанием 44 см и равными сторонами 42 см	[{"type": "triangle", "name": "WOG"}, {"type": "triangle", "name": "VTM"}]
Найдите сумму внутренних углов равнобедренного треугольника OLM с основанием 22 см и равными сторонами 20 см, а также разностороннего треугольника XTH со сторонами 25 см, 27 см и 30 см	[{"type": "triangle", "name": "OLM"}, {"type": "triangle", "name": "XTH"}]
Определите гипотенузу равнобедренного треугольника URZ с основанием 18 см и равными сторонами 16 см, а также прямоугольного треугольника FKN с катетами 16 см и 30 см	[{"type": "triangle", "name": "URZ"}, {"type": "triangle", "name": "FKN"}]
Найдите периметр трапеции KCNO, основания которой равны 20 см и 25 см, а высота — 16 см.	[{"type": "trapezoid", "name": "KCNO"}]
Докажите, что противолежащие углы параллелограмма ZUHB являются дополнительными.	[{"type": "parallelogram", "name": "ZUHB"}]
Определите сумму внутренних углов остроугольного треугольника TRU с углами 45°, 60° и 75°, а также равностороннего треугольника OCB со стороной 62 см	[{"type": "triangle", "name": "TRU"}, {"type": "triangle", "name": "OCB"}]
В трапеции ZFRD, если ∠A = 80° и ∠B = 70°, найдите сумму оставшихся двух углов.	[{"type": "trapezoid", "name": "ZFRD"}]
Найдите величину ∠C в параллелограмме HKAF, если ∠A = 50°.	[{"type": "parallelogram", "name": "HKAF"}]
Найдите периметр четырехугольника YGPR со сторонами длиной 14 см, 16 см, 18 см и 20 см.	[{"type": "quadrilateral", "name": "YGPR"}]
Докажите, что сумма внутренних углов квадрата TSKM равна 360°.	[{"type": "square", "name": "TSKM"}]
Вычислите площадь треугольника UHN, зная, что его стороны равны 9 см, 12 см и 15 см.	[{"type": "triangle", "name": "UHN"}]
Найдите величину ∠A в четырехугольнике ETVN, если диагонали AC и BD пересекаются под углом 60°.	[{"type": "quadrilateral", "name": "ETVN"}]
В квадрате MDAI, если AB = BC = CD = DA, найдите меру ∠A.	[{"type": "square", "name": "MDAI"}]
Найдите величину ∠B в трапеции MJZD, если ∠A = 90°.	[{"type": "trapezoid", "name": "MJZD"}]
Вычислите углы треугольника JKO, если два угла дополнительные, а третий угол равен 100°.	[{"type": "triangle", "name": "JKO"}]
Найдите длину диагонали трапеции DJQU, основания которой равны 22 см и 25 см, а высота — 16 см.	[{"type": "trapezoid", "name": "DJQU"}]
Найдите длину диагонали квадрата NPHG со стороной 40 см.	[{"type": "square", "name": "NPHG"}]
Определите, является ли треугольник RWG прямоугольным, если гипотенуза равна 18 см, а длина одного катета 15 см.	[{"type": "triangle", "name": "RWG"}]
Найдите длину медианы из вершины B в треугольнике KSG со сторонами длиной 5, 6 и 7 единиц и докажите, что она делит пополам угол между сторонами DE и DF	[{"type": "triangle", "name": "KSG"}]
Как называется трапеция AWOB с двумя парами равных сторон?	[{"type": "trapezoid", "name": "AWOB"}]
Найдите величину ∠A в квадрате INMW, если диагонали AC и BD пересекаются под углом 90°.	[{"type": "square", "name": "INMW"}]
Найдите величину ∠A в трапеции CZXK, если AB = 18 см, BC = 20 см, CD = 18 см и DA = 20 см.	[{"type": "trapezoid", "name": "CZXK"}]
Докажите, что диагонали параллелограмма VQPT точкой пересечения образуют угол 90°.	[{"type": "parallelogram", "name": "VQPT"}]
Какова площадь параллелограмма BVOK, основание которого равно 16 см, а высота — 18 см?	[{"type": "parallelogram", "name": "BVOK"}]
В четырехугольнике GCHN, если ∠A = 80° и ∠B = 100°, найдите сумму оставшихся двух углов.	[{"type": "quadrilateral", "name": "GCHN"}]
Найдите величину ∠B в четырехугольнике IGHV, если ∠A = 75°.	[{"type": "quadrilateral", "name": "IGHV"}]
Найдите длину диагонали параллелограмма VMHD, стороны которого равны 16 см и 20 см.	[{"type": "parallelogram", "name": "VMHD"}]
Найдите площадь четырехугольника JSCU, основание которого равно 10 см, высота 6 см и один угол равен 60°.	[{"type": "quadrilateral", "name": "JSCU"}]
Как называется параллелограмм XURD, если AB = CD и AD = BC?	[{"type": "parallelogram", "name": "XURD"}]
Найдите периметр квадрата GOTQ со стороной 70 см.	[{"type": "square", "name": "GOTQ"}]
Докажите, что диагонали квадрата ZIHL пересекаются и делятся пополам под углом 90°.	[{"type": "square", "name": "ZIHL"}]
Как называется четырехугольник CWZR, у которого все углы прямые?	[{"type": "quadrilateral", "name": "CWZR"}]
Определите, является ли треугольник JAP прямоугольным, если гипотенуза равна 14 см, а длина одного катета 12 см.	[{"type": "triangle", "name": "JAP"}]
Найдите периметр трапеции GWXH, основания которой равны 22 см и 25 см, а высота — 18 см.	[{"type": "trapezoid", "name": "GWXH"}]
Найдите периметр трапеции RWGQ, основания которой равны 16 см и 18 см, а высота 12 см.	[{"type": "trapezoid", "name": "RWGQ"}]
Найдите длину диагонали трапеции VXAG, основания которой равны 22 см и 25 см, а высота — 16 см.	[{"type": "trapezoid", "name": "VXAG"}]
Определите площадь прямоугольного треугольника SVW с катетами 58 см и 70 см, а также остроугольного треугольника BTI с углами 30°, 60° и 90°	[{"type": "triangle", "name": "SVW"}, {"type": "triangle", "name": "BTI"}]
Определите гипотенузу равнобедренного треугольника HZG с основанием 18 см и равными сторонами 16 см, а также прямоугольного треугольника PXY с катетами 16 см и 30 см	[{"type": "triangle", "name": "HZG"}, {"type": "triangle", "name": "PXY"}]
Определите периметр тупоугольного треугольника UAX со сторонами 74 см, 76 см и 92 см и остроугольного треугольника FSL с углами 30°, 60° и 90°	[{"type": "triangle", "name": "UAX"}, {"type": "triangle", "name": "FSL"}]
Найдите площадь четырехугольника VAIT, основание которого равно 22 см, а высота — 20 см.	[{"type": "quadrilateral", "name": "VAIT"}]
Как называется квадрат JHLI, у которого все углы прямые?	[{"type": "square", "name": "JHLI"}]
Докажите, что диагонали квадрата ESBX пересекаются и делятся пополам под углом 90°.	[{"type": "square", "name": "ESBX"}]
Найдите высоту остроугольного треугольника LSX с углами 45°, 60° и 75°, а также равнобедренного треугольника HDI с основанием 25 см и равными сторонами 23 см	[{"type": "triangle", "name": "LSX"}, {"type": "triangle", "name": "HDI"}]
Найдите периметр квадрата JBMA со стороной 12 см.	[{"type": "square", "name": "JBMA"}]
Найдите длину диагонали четырехугольника GFRY, стороны которого равны 5 см, 6 см и 8 см.	[{"type": "quadrilateral", "name": "GFRY"}]
Найдите периметр квадрата OGUW со стороной 60 см.	[{"type": "square", "name": "OGUW"}]
Какова площадь параллелограмма XSVT, основание которого равно 10 см, а высота — 8 см?	[{"type": "parallelogram", "name": "XSVT"}]
Докажите, что диагонали параллелограмма BFIA являются взаимно перпендикулярными и серединными.	[{"type": "parallelogram", "name": "BFIA"}]
Найдите величину ∠D в четырехугольнике SGRX, если ∠A = 50°.	[{"type": "quadrilateral", "name": "SGRX"}]
Найдите периметр трапеции XWHO, основания которой равны 20 см и 25 см, а высота — 16 см.	[{"type": "trapezoid", "name": "XWHO"}]
Найдите периметр четырехугольника DTUZ со сторонами 12 см, 15 см, 18 см и 20 см.	[{"type": "quadrilateral", "name": "DTUZ"}]
Определите периметр прямоугольного треугольника ADS со сторонами 88 см и 108 см и разностороннего треугольника QWB со сторонами 90 см, 92 см и 112 см	[{"type": "triangle", "name": "ADS"}, {"type": "triangle", "name": "QWB"}]
Определите, является ли треугольник JZW треугольником 30-60-90, если его стороны имеют длины 5, 12 и 13 единиц. Приведите доказательство или контрпример.	[{"type": "triangle", "name": "JZW"}]
Как называется трапеция HWPN с двумя парами равных сторон?	[{"type": "trapezoid", "name": "HWPN"}]
Вычислите высоту равностороннего треугольника LBS со стороной 24 см и остроугольного треугольника EXJ с углами 30°, 60° и 90°	[{"type": "triangle", "name": "LBS"}, {"type": "triangle", "name": "EXJ"}]
Найдите площадь четырехугольника EOQU с вершинами в точках (0, 0), (8, 0), (8, 12) и (0, 12).	[{"type": "quadrilateral", "name": "EOQU"}]
Как называется трапеция MVUY, у которой все стороны имеют одинаковую длину?	[{"type": "trapezoid", "name": "MVUY"}]
Найдите площадь трапеции SNFJ, основания которой равны 18 см и 20 см, а высота 16 см.	[{"type": "trapezoid", "name": "SNFJ"}]
Найдите периметр квадрата QCZH со стороной 15 см.	[{"type": "square", "name": "QCZH"}]
Найдите длину медианы из вершины C в треугольнике LQY с сторонами длины 3, 4 и 5 единиц и докажите, что он делит треугольник на две равные области	[{"type": "triangle", "name": "LQY"}]
Найдите периметр равнобедренного треугольника ZJI с основанием 9 см и равными сторонами 7 см, а также остроугольного треугольника BRA с углами 30°, 60° и 90°	[{"type": "triangle", "name": "ZJI"}, {"type": "triangle", "name": "BRA"}]
Докажите, что сумма внутренних углов квадрата YQWT равна 360°.	[{"type": "square", "name": "YQWT"}]
В трапеции LGFN, если AB = CD и AD = BC, как называется трапеция?	[{"type": "trapezoid", "name": "LGFN"}]
Найдите площадь треугольника ARB с периметром 24 см и медианой 12 см.	[{"type": "triangle", "name": "ARB"}]
Докажите, что диагонали четырехугольника OHSI точкой пересечения делятся пополам.	[{"type": "quadrilateral", "name": "OHSI"}]
Найдите величину ∠A в трапеции PSCT, если AB = 22 см, BC = 25 см, CD = 22 см и DA = 25 см.	[{"type": "trapezoid", "name": "PSCT"}]
Найдите периметр параллелограмма CSUR со сторонами длиной 17 см и 22 см.	[{"type": "parallelogram", "name": "CSUR"}]
Найдите величину ∠A в четырехугольнике SMCP, если диагонали AC и BD пересекаются под углом 45°.	[{"type": "quadrilateral", "name": "SMCP"}]
В параллелограмме YGJO, если ∠A = 70°, найдите величину ∠B.	[{"type": "parallelogram", "name": "YGJO"}]
Найдите площадь остроугольного треугольника LQT с углами 45°, 60° и 75° и разностороннего треугольника IMK со сторонами 16 см, 18 см и 22 см	[{"type": "triangle", "name": "LQT"}, {"type": "triangle", "name": "IMK"}]
Определите, возможен ли треугольник QXC со сторонами длиной 4 см, 8 см и 7 см.	[{"type": "triangle", "name": "QXC"}]
В трапеции KVXD, если ∠A = 90°, найдите меру ∠B.	[{"type": "trapezoid", "name": "KVXD"}]
Вычислите координаты центра и радиус вписанной окружности для треугольника TFW с вершинами (1, 2), (3, 4) и (5, 6)	[{"type": "triangle", "name": "TFW"}]
Вычислите недостающую величину угла в треугольнике WUH, если углы относятся как 1:2:3.	[{"type": "triangle", "name": "WUH"}]
Как называется трапеция GQSD, у которой все стороны имеют одинаковую длину?	[{"type": "trapezoid", "name": "GQSD"}]
Найдите величину ∠C в трапеции QTPH, если ∠A = 65°.	[{"type": "trapezoid", "name": "QTPH"}]
В треугольнике IPS, если углы относятся как 4:5:6, найдите величину наименьшего угла.	[{"type": "triangle", "name": "IPS"}]
Найдите площадь четырехугольника IYMQ, основание которого равно 20 см, а высота — 18 см.	[{"type": "quadrilateral", "name": "IYMQ"}]
Найдите площадь квадрата UCHP со стороной 28 см.	[{"type": "square", "name": "UCHP"}]
Вычислите высоту равностороннего треугольника TJM с длиной стороны 8 единиц	[{"type": "triangle", "name": "TJM"}]
Найдите периметр квадрата QFYH со стороной 38 см.	[{"type": "square", "name": "QFYH"}]
Как называется четырехугольник DPVT, если AB=CD и AD=BC?	[{"type": "quadrilateral", "name": "DPVT"}]
Найдите периметр четырехугольника MNJQ со сторонами длиной 20 см, 22 см, 24 см и 26 см.	[{"type": "quadrilateral", "name": "MNJQ"}]
Докажите, что диагонали параллелограмма VMEO точкой пересечения образуют угол 90°.	[{"type": "parallelogram", "name": "VMEO"}]
Найдите длину диагонали квадрата HRLQ со стороной 30 см.	[{"type": "square", "name": "HRLQ"}]
Какова площадь трапеции LCPZ, основания которой равны 22 см и 25 см, а высота 18 см?	[{"type": "trapezoid", "name": "LCPZ"}]
Найдите длину диагонали четырехугольника FKHY, стороны которого равны 16 см, 18 см и 20 см.	[{"type": "quadrilateral", "name": "FKHY"}]
В трапеции LQWM, если ∠A = 80° и ∠B = 70°, найдите сумму оставшихся двух углов.	[{"type": "trapezoid", "name": "LQWM"}]
Найдите сумму внутренних углов разностороннего треугольника EQC со сторонами 15 см, 18 см и 20 см, а также равнобедренного треугольника NKF с основанием 12 см и равными сторонами 10 см	[{"type": "triangle", "name": "EQC"}, {"type": "triangle", "name": "NKF"}]
В четырехугольнике HOAP, если ∠A = 90° и ∠B = 60°, найти меру ∠C.	[{"type": "quadrilateral", "name": "HOAP"}]
Докажите, что диагонали квадрата LSFX пересекаются и делятся пополам под углом 90°.	[{"type": "square", "name": "LSFX"}]
Докажите, что противоположные стороны параллелограмма COWS равны.	[{"type": "parallelogram", "name": "COWS"}]
Найдите площадь параллелограмма DOAW, основание которого равно 11 см, а высота — 10 см.	[{"type": "parallelogram", "name": "DOAW"}]
В квадрате SQPM, если ∠A = 90°, найдите величину ∠B.	[{"type": "square", "name": "SQPM"}]
Вычислите площадь равнобедренного треугольника VRZ с основанием 42 см и равными сторонами 40 см, а также разностороннего треугольника EHY со сторонами 50 см, 52 см и 60 см	[{"type": "triangle", "name": "VRZ"}, {"type": "triangle", "name": "EHY"}]
Определите гипотенузу остроугольного треугольника QFB с углами 45°, 60° и 75° и разностороннего треугольника ZGC со сторонами 34 см, 36 см и 42 см	[{"type": "triangle", "name": "QFB"}, {"type": "triangle", "name": "ZGC"}]
Найдите периметр параллелограмма MHCF со сторонами 11 см и 13 см.	[{"type": "parallelogram", "name": "MHCF"}]
Найдите недостающую величину угла в HYO равностороннего треугольника.	[{"type": "triangle", "name": "HYO"}]
Как называется четырехугольник USPM с двумя парами равных сторон?	[{"type": "quadrilateral", "name": "USPM"}]
В квадрате CXKT, если AB = CD и AD = BC, как называется квадрат?	[{"type": "square", "name": "CXKT"}]
Найдите площадь прямоугольного треугольника QRX с катетами 32 см и 40 см, а также равностороннего треугольника MIB со стороной 32 см	[{"type": "triangle", "name": "QRX"}, {"type": "triangle", "name": "MIB"}]
В четырёхугольнике UOHP, если ∠A + ∠C = 180°, как называется четырёхугольник?	[{"type": "quadrilateral", "name": "UOHP"}]
Вычислите периметр разностороннего треугольника RVM со сторонами 94 см, 96 см и 118 см, а также равностороннего треугольника QSF со стороной 92 см	[{"type": "triangle", "name": "RVM"}, {"type": "triangle", "name": "QSF"}]
Определите тип треугольника RSP, образованного точками A(-2, 3), B(1, 4) и C(5, -1) по их координатам	[{"type": "triangle", "name": "RSP"}]
Найдите высоту остроугольного треугольника OZL с углами 45°, 60° и 75°, а также равнобедренного треугольника BAI с основанием 40 см и равными сторонами 38 см	[{"type": "triangle", "name": "OZL"}, {"type": "triangle", "name": "BAI"}]
Найдите величину ∠D в параллелограмме GZKD, если ∠A = 110°.	[{"type": "parallelogram", "name": "GZKD"}]
Докажите, что противоположные стороны параллелограмма FYJU равны.	[{"type": "parallelogram", "name": "FYJU"}]
Как называется квадрат FIYM, у которого все углы прямые?	[{"type": "square", "name": "FIYM"}]
Определите медиану прямоугольного равнобедренного треугольника SZG с длиной катета 10 и 10 единиц	[{"type": "triangle", "name": "SZG"}]
Как называется квадрат FZXM, у которого все стороны одинаковой длины и все углы прямые?	[{"type": "square", "name": "FZXM"}]
Какова высота треугольника NYJ, если его площадь 40 квадратных сантиметров?	[{"type": "triangle", "name": "NYJ"}]
Как называется четырехугольник PBOK, если диагонали AC и BD перпендикулярны друг другу?	[{"type": "quadrilateral", "name": "PBOK"}]
Найдите периметр параллелограмма QXPD, стороны которого равны 9 см и 11 см.	[{"type": "parallelogram", "name": "QXPD"}]
Определите площадь прямоугольного треугольника KIY с катетами 80 см и 100 см, а также остроугольного треугольника DRS с углами 30°, 60° и 90°	[{"type": "triangle", "name": "KIY"}, {"type": "triangle", "name": "DRS"}]
В трапеции JGKP, если AB = CD и AD = BC, как называется трапеция?	[{"type": "trapezoid", "name": "JGKP"}]
Как называется квадрат DWAO, у которого все стороны одинаковой длины и все углы прямые?	[{"type": "square", "name": "DWAO"}]
Найдите площадь параллелограмма LTYJ с вершинами в точках (0, 0), (6, 0), (6, 10) и (0, 10).	[{"type": "parallelogram", "name": "LTYJ"}]
Найдите величину ∠A в трапеции LSZQ, если диагонали AC и BD пересекаются под углом 60°.	[{"type": "trapezoid", "name": "LSZQ"}]
Докажите, что диагонали квадрата BDSO пересекаются и делятся пополам под углом 90°.	[{"type": "square", "name": "BDSO"}]
Как называется параллелограмм JHGU, если AB = CD и AD = BC?	[{"type": "parallelogram", "name": "JHGU"}]
Определите площадь прямоугольного треугольника LGV с катетами 35 см и 42 см, а также остроугольного треугольника JKN с углами 30°, 60° и 90°	[{"type": "triangle", "name": "LGV"}, {"type": "triangle", "name": "JKN"}]
Найдите площадь четырехугольника UMKD с вершинами в точках (0, 0), (2, 0), (2, 4) и (0, 4).	[{"type": "quadrilateral", "name": "UMKD"}]
Рассчитайте длину высоты от вершины C в треугольнике OKE с сторонами длины 3, 4 и 5 единиц и используйте его, чтобы найти расстояние между средними точками боковых сторон LM и Mn	[{"type": "triangle", "name": "OKE"}]
Докажите, что диагонали трапеции PYAK пересекаются под углом 90°.	[{"type": "trapezoid", "name": "PYAK"}]
Найдите площадь четырехугольника PQNX с вершинами в точках (0, 0), (9, 0), (9, 15) и (0, 15).	[{"type": "quadrilateral", "name": "PQNX"}]
Вычислите высоту разностороннего треугольника WKG со сторонами 100 см, 102 см и 130 см, а также равнобедренного треугольника BVA с основанием 88 см и равными сторонами 86 см	[{"type": "triangle", "name": "WKG"}, {"type": "triangle", "name": "BVA"}]
В квадрате HDCO, если ∠A = 90°, найдите меру ∠D.	[{"type": "square", "name": "HDCO"}]
В четырехугольнике PQOT, если ∠A = 90° и ∠B = 60°, найти меру ∠C.	[{"type": "quadrilateral", "name": "PQOT"}]
